EEN NETFLIX ORIGINAL-SERIE	EEN NETFLIX ORIGINAL-SERIE
Ik ga je zo missen.	Ik ga je zo missen.
Hup. Op je knieën. En jij ook. Hup, hup.	Hup. Op je knieën. En jij ook. Hup, hup.
Ga je mee? Kom.	Ga je mee? Kom.
Schaamte, schuldgevoel, verlegenheid en angst.	Schaamte, schuldgevoel, verlegenheid en angst.
Met één druk op de stimulator die elektroden in de hersenen aanstuurt...	Met één druk op de stimulator die elektroden in de hersenen aanstuurt...
...helpen wij op dit ogenblik mensen met OCS, tremor en parkinson.	...helpen wij op dit ogenblik mensen met OCS, tremor en parkinson.
Er is in de geneeskunde geen enkele behandeling...	Er is in de geneeskunde geen enkele behandeling...
...die sneller en effectiever werkt dan Deep Brain Stimulation.	...die sneller en effectiever werkt dan Deep Brain Stimulation.
Wie van jullie...	Wie van jullie...
...slikt er weleens een pilletje? -[gelach]	...slikt er weleens een pilletje? -[gelach]
XTC, MDMA, eerlijk zeggen.	XTC, MDMA, eerlijk zeggen.
Dan kennen jullie waarschijnlijk allemaal de kater na afloop...	Dan kennen jullie waarschijnlijk allemaal de kater na afloop...
...dat schuldgevoel, de schaamte, de zwaarte.	...dat schuldgevoel, de schaamte, de zwaarte.
Er zijn mensen die zich iedere dag zo voelen.	Er zijn mensen die zich iedere dag zo voelen.
Stel je nou voor dat we die mensen hiervan kunnen verlossen.	Stel je nou voor dat we die mensen hiervan kunnen verlossen.
Een dragelijk leven voor iedereen dankzij DBS.	Een dragelijk leven voor iedereen dankzij DBS.
Een vraag.	Een vraag.
Ik ben Rosa, eerstejaars geneeskunde...	Ik ben Rosa, eerstejaars geneeskunde...
...ik vroeg me af, wat is de doelgroep van deze behandeling?	...ik vroeg me af, wat is de doelgroep van deze behandeling?
Wie denkt u dat in aanmerking komen?	Wie denkt u dat in aanmerking komen?
De mensen die daar behoefte aan hebben.	De mensen die daar behoefte aan hebben.
Waarom vraag je dat?	Waarom vraag je dat?
Nou, omdat...	Nou, omdat...
...de technieken waar jullie aan werken best prijzig zijn.	...de technieken waar jullie aan werken best prijzig zijn.
Enkel weggelegd voor vermogende mensen.	Enkel weggelegd voor vermogende mensen.
De rest moet 't maar doen met nog een pilletje, toch?	De rest moet 't maar doen met nog een pilletje, toch?
Ik denk niet dat dit nu relevant is.	Ik denk niet dat dit nu relevant is.
Dat is op zich een prima vraag. DBS in de huidige vorm is inderdaad duur.	Dat is op zich een prima vraag. DBS in de huidige vorm is inderdaad duur.
Maar...	Maar...
...ik moet eerlijk zeggen:	...ik moet eerlijk zeggen:
ik experimenteer liever op mensen met een gouden horloge...	ik experimenteer liever op mensen met een gouden horloge...
...dan op patiënten die alles al kwijt zijn.	...dan op patiënten die alles al kwijt zijn.
Rosa.	Rosa.
Dit was het.	Dit was het.
Willen jullie weten wie er stage mag lopen bij mevrouw De Hoogh?	Willen jullie weten wie er stage mag lopen bij mevrouw De Hoogh?
De gelukkigen...	De gelukkigen...
die zijn uitgenodigd voor 'n stage bij het Hoogh Instituut...	die zijn uitgenodigd voor 'n stage bij het Hoogh Instituut...
...zijn Vera Cavalho...	...zijn Vera Cavalho...
...Derk-Jan van der Vorm...	...Derk-Jan van der Vorm...
...Hendrik Dreesman, Arnold van Swieten...	...Hendrik Dreesman, Arnold van Swieten...
...en dan de laatste, de enige eerstejaars...	...en dan de laatste, de enige eerstejaars...
...Fleur Borms.	...Fleur Borms.
Felicitaties voor dit vijftal.	Felicitaties voor dit vijftal.
Mevrouw de Hoogh nodigt de geselecteerde stagiaires uit voor een receptie.	Mevrouw de Hoogh nodigt de geselecteerde stagiaires uit voor een receptie.
Bedankt.	Bedankt.
Mam?	Mam?
Pap?	Pap?
Stil.	Stil.
[vader] Ik zie jullie morgenochtend.	[vader] Ik zie jullie morgenochtend.
We eten met een uurtje.	We eten met een uurtje.
Het volgende semester meer macro- economie, kansrekening en statistiek.	Het volgende semester meer macro- economie, kansrekening en statistiek.
Eet je mee? -We hebben niet genoeg.	Eet je mee? -We hebben niet genoeg.
Ik wou eigenlijk wat gaan eten in de stad.	Ik wou eigenlijk wat gaan eten in de stad.
En ik dacht, misschien vind je het leuk om mee te eten?	En ik dacht, misschien vind je het leuk om mee te eten?
Je ziet toch dat ik niet weg kan?	Je ziet toch dat ik niet weg kan?
Kom op, Roos. Jullie hebben elkaar lang niet gezien.	Kom op, Roos. Jullie hebben elkaar lang niet gezien.
Het kan ook 'n andere keer. -[zucht] Ga met Jacob mee.	Het kan ook 'n andere keer. -[zucht] Ga met Jacob mee.
Ik heb gekookt.	Ik heb gekookt.
Hé, ga gewoon.	Hé, ga gewoon.
Ik red me prima.	Ik red me prima.
Oké.	Oké.
Veel plezier. Bye. -Bedankt. Doei.	Veel plezier. Bye. -Bedankt. Doei.
En, slikt ze haar pillen nog?	En, slikt ze haar pillen nog?
Ze kreeg bijwerkingen van de Depakine, dus nu zijn we overgestapt op Zyprexa...	Ze kreeg bijwerkingen van de Depakine, dus nu zijn we overgestapt op Zyprexa...
...maar dat is kutspul, man. Ik vind dat ze aan de Clozapine moet.	...maar dat is kutspul, man. Ik vind dat ze aan de Clozapine moet.
Wat?	Wat?
Je klinkt als een echte arts.	Je klinkt als een echte arts.
Ja, ik werk kapot hard.	Ja, ik werk kapot hard.
Wat dacht je ervan om...	Wat dacht je ervan om...
...uit huis te gaan?	...uit huis te gaan?
De stad uit?	De stad uit?
Uit Amsterdam?	Uit Amsterdam?
Waarheen? Alles wat ik belangrijk vind, zit hier.	Waarheen? Alles wat ik belangrijk vind, zit hier.
Hoezo? Alleen je ouders, toch?	Hoezo? Alleen je ouders, toch?
Ik dacht dat wij beste vrienden waren?	Ik dacht dat wij beste vrienden waren?
Dat zijn we toch ook?	Dat zijn we toch ook?
Wat is dit?	Wat is dit?
Is dit een soort afscheidsdiner, of zo?	Is dit een soort afscheidsdiner, of zo?
Ik zie jou drie maanden niet. Je reageert niet op appjes...	Ik zie jou drie maanden niet. Je reageert niet op appjes...
...waar ben je als ik je nodig heb?	...waar ben je als ik je nodig heb?
Ik ben er voor jou, maar ik hoef niet met jou te chillen. Ik heb genoeg mensen.	Ik ben er voor jou, maar ik hoef niet met jou te chillen. Ik heb genoeg mensen.
Ik leg het je uit in de taxi, ja?	Ik leg het je uit in de taxi, ja?
Oké. -Mogen we alsjeblieft betalen?	Oké. -Mogen we alsjeblieft betalen?
Er is al betaald, meneer. Door die tafel daar.	Er is al betaald, meneer. Door die tafel daar.
Wat? Wie zijn dat? -Hm?	Wat? Wie zijn dat? -Hm?
Roos, ik leg het uit in de taxi.	Roos, ik leg het uit in de taxi.
Laten we alsjeblieft...	Laten we alsjeblieft...
Roos, Roos.	Roos, Roos.
Oké, daar gaan we.	Oké, daar gaan we.
Wat is jullie probleem?	Wat is jullie probleem?
Laat Jacob met rust, oké?	Laat Jacob met rust, oké?
Jacob?	Jacob?
Je hoort me toch? -O, je bedoelt onze student-noviet.	Je hoort me toch? -O, je bedoelt onze student-noviet.
Van welke club zijn jullie?	Van welke club zijn jullie?
Jullie zijn toch van een studentenvereniging, of niet?	Jullie zijn toch van een studentenvereniging, of niet?
Ja.	Ja.
Jij? -Wat denk je zelf?	Jij? -Wat denk je zelf?
Wat studeer je? -Geneeskunde.	Wat studeer je? -Geneeskunde.
Sorry, wie was jij ook alweer? -En wat is je eindstation?	Sorry, wie was jij ook alweer? -En wat is je eindstation?
Marije.	Marije.
Ja, gewoon interesse.	Ja, gewoon interesse.
UBC, Johns Hopkins, Cambridge? -Amsterdam.	UBC, Johns Hopkins, Cambridge? -Amsterdam.
Amsterdam is goed genoeg voor sommigen. -Voor jou niet?	Amsterdam is goed genoeg voor sommigen. -Voor jou niet?
Ik heb ambities. -Carmen.	Ik heb ambities. -Carmen.
Let maar niet op haar. Ze vindt weinig goed genoeg.	Let maar niet op haar. Ze vindt weinig goed genoeg.
Juist. Daarom gaan we hier ook weg. Toch, Jacob?	Juist. Daarom gaan we hier ook weg. Toch, Jacob?
Ik wou eigenlijk net Rosa naar de taxi brengen.	Ik wou eigenlijk net Rosa naar de taxi brengen.
Waar heb je 't over? Jullie gaan mee.	Waar heb je 't over? Jullie gaan mee.
Kom, ik breng je thuis, oké?	Kom, ik breng je thuis, oké?
Nee, ik ben wel benieuwd.	Nee, ik ben wel benieuwd.
Roos, kunnen we alsjeblieft gaan?	Roos, kunnen we alsjeblieft gaan?
Ik wil niet dat... -Dat ik je nieuwe vrienden ontmoet?	Ik wil niet dat... -Dat ik je nieuwe vrienden ontmoet?
Te laat.	Te laat.
Daar zijn ze.	Daar zijn ze.
Onze betovergrootvaders.	Onze betovergrootvaders.
Zijn dat ze?	Zijn dat ze?
Marije, welke waren ook alweer van jou? -In het midden.	Marije, welke waren ook alweer van jou? -In het midden.
Die daar rechts is van Carmen. Toch, Car?	Die daar rechts is van Carmen. Toch, Car?
Rembrandt heeft hier maar 3200 euro voor gekregen.	Rembrandt heeft hier maar 3200 euro voor gekregen.
De Zwaan.	De Zwaan.
Die staat symbool voor Johan de Witt.	Die staat symbool voor Johan de Witt.
De regent uit de Gouden Eeuw.	De regent uit de Gouden Eeuw.
Vermoord door het volk.	Vermoord door het volk.
Het gaat mij om haar houding.	Het gaat mij om haar houding.
De kracht die zij uitstraalt.	De kracht die zij uitstraalt.
Jullie zijn geen normale studentenvereniging, of wel?	Jullie zijn geen normale studentenvereniging, of wel?
Ik heb Jacob nog nooit zo gespannen gezien.	Ik heb Jacob nog nooit zo gespannen gezien.
We zijn 'n genootschap.	We zijn 'n genootschap.
Wat voor genootschap?	Wat voor genootschap?
Voor rijke studenten?	Voor rijke studenten?
Niet per se.	Niet per se.
Voor mensen met potentie.	Voor mensen met potentie.
En wat moet ik doen om daarbij te komen?	En wat moet ik doen om daarbij te komen?
Het ei.	Het ei.
Holland.	Holland.
De burgers die door de zwaan beschermd moeten worden tegen de hond.	De burgers die door de zwaan beschermd moeten worden tegen de hond.
De vijand. -En ik ben zeker het ei?	De vijand. -En ik ben zeker het ei?
[lachje] Dat zijn jouw woorden.	[lachje] Dat zijn jouw woorden.
Ik dacht dat lid zijn niks voor jou was, Rosa.	Ik dacht dat lid zijn niks voor jou was, Rosa.
Ik heb geen idee, Carmen. Je vertelt me niks.	Ik heb geen idee, Carmen. Je vertelt me niks.
Ze zijn er.	Ze zijn er.
Goed, Rosa.	Goed, Rosa.
Leuk je te ontmoeten.	Leuk je te ontmoeten.
Wel thuis.	Wel thuis.
Hadden jullie het leuk?	Hadden jullie het leuk?
Ja.	Ja.
Jacob is lief.	Jacob is lief.
Dankjewel, Roosje.	Dankjewel, Roosje.
Voor wat?	Voor wat?
Alles.	Alles.
Ik red me prima.	Ik red me prima.
[vervormde stem] Rosa Steenwijk, je wordt vandaag om 18.00 uur...	[vervormde stem] Rosa Steenwijk, je wordt vandaag om 18.00 uur...
...opgehaald op de volgende locatie:	...opgehaald op de volgende locatie:
de bibliotheek van de universiteit.	de bibliotheek van de universiteit.
Op uitnodiging van:	Op uitnodiging van:
Het Ares-genootschap.	Het Ares-genootschap.
Roos?	Roos?
Hoe ging het vannacht met mama?	Hoe ging het vannacht met mama?
Goed.	Goed.
De buurvrouw zei dat mama de hele avond op 't balkon heeft staan schreeuwen.	De buurvrouw zei dat mama de hele avond op 't balkon heeft staan schreeuwen.
Waar was je?	Waar was je?
Met Jacob.	Met Jacob.
We kunnen niet zomaar weg.	We kunnen niet zomaar weg.
Ja.	Ja.
Luister.	Luister.
Ik heb de hele week nachtdienst.	Ik heb de hele week nachtdienst.
Ik ben er.	Ik ben er.
Dit is haar tweede aanval deze week.	Dit is haar tweede aanval deze week.
We moeten er echt voor haar zijn.	We moeten er echt voor haar zijn.
Ik ben er.	Ik ben er.
Men heeft 'n schuldgevoel en kan niet meedraaien in onze maatschappij.	Men heeft 'n schuldgevoel en kan niet meedraaien in onze maatschappij.
Volgende. Er is sprake van een dysthyme stoornis...	Volgende. Er is sprake van een dysthyme stoornis...
...als de ziekte minimaal twee jaar duurt.	...als de ziekte minimaal twee jaar duurt.
Deze patiënt... Een vraag?	Deze patiënt... Een vraag?
Ja. Dit staat toch ook allemaal op het blackboard?	Ja. Dit staat toch ook allemaal op het blackboard?
Dat klopt, ja.	Dat klopt, ja.
Dus deze informatie kunnen we ook downloaden van de server?	Dus deze informatie kunnen we ook downloaden van de server?
Ja. Dat klopt. En ik ben hier om het uit te leggen.	Ja. Dat klopt. En ik ben hier om het uit te leggen.
Een hersengebied dat hypothetisch bij depressie overactief is...	Een hersengebied dat hypothetisch bij depressie overactief is...
...is het subgenuale gebied. -[keelschraap]	...is het subgenuale gebied. -[keelschraap]
Waarom ben ik hier dan?	Waarom ben ik hier dan?
Hebt u kritiek op mijn lesgeven, mejuffrouw Steenwijk?	Hebt u kritiek op mijn lesgeven, mejuffrouw Steenwijk?
Absoluut.	Absoluut.
Ik wil gewoon iets meer weten over de... -Wilt u zelf voor de klas komen staan?	Ik wil gewoon iets meer weten over de... -Wilt u zelf voor de klas komen staan?
Nee. Ik wil gewoon worden uitgedaagd.	Nee. Ik wil gewoon worden uitgedaagd.
Maar u kunt dat blijkbaar niet.	Maar u kunt dat blijkbaar niet.
Oef.	Oef.
Misschien kinderachtig, maar als uitdaging schrijven jullie allemaal een paper.	Misschien kinderachtig, maar als uitdaging schrijven jullie allemaal een paper.
Voor 't einde van volgende week... -Bedankt.	Voor 't einde van volgende week... -Bedankt.
...gebaseerd op mijn sheets en die zijn uiteraard te vinden op de server.	...gebaseerd op mijn sheets en die zijn uiteraard te vinden op de server.
Jacob.	Jacob.
Hoe was het?	Hoe was het?
Jij was toch gebleven?	Jij was toch gebleven?
Hoe bedoel je?	Hoe bedoel je?
Nou, het was raar, toch? Gister?	Nou, het was raar, toch? Gister?
Ik moet maar mijn les.	Ik moet maar mijn les.
Nou, zeg even.	Nou, zeg even.
Geef gewoon antwoord.	Geef gewoon antwoord.
Ik vraag je wat. -Ja, dus?	Ik vraag je wat. -Ja, dus?
Hallo, even serieus. Dat was toch raar?	Hallo, even serieus. Dat was toch raar?
Dineren in het Rijksmuseum?	Dineren in het Rijksmuseum?
En die Carmen, what the fuck?	En die Carmen, what the fuck?
Wat was dat? Wie zijn jouw nieuwe vrienden?	Wat was dat? Wie zijn jouw nieuwe vrienden?
Het zijn geen vrienden, 't is...	Het zijn geen vrienden, 't is...
Het Ares-genootschap.	Het Ares-genootschap.
Laat het gaan. Ik moet naar de les.	Laat het gaan. Ik moet naar de les.
Jacob Wessels.	Jacob Wessels.
Roos, laat het gaan, ja? Het is gewoon domme studentenshit, oké?	Roos, laat het gaan, ja? Het is gewoon domme studentenshit, oké?
Stop met vragen. -Ik wil alleen maar weten...	Stop met vragen. -Ik wil alleen maar weten...
Voor je eigen bestwil, bemoei je er niet mee. Oké?	Voor je eigen bestwil, bemoei je er niet mee. Oké?
Niemand bepaalt wat ik wel of niet doe.	Niemand bepaalt wat ik wel of niet doe.
[adem in - adem uit] Het is, ik...	[adem in - adem uit] Het is, ik...
Hé, rustig. Ga maar zitten.	Hé, rustig. Ga maar zitten.
Alsjeblieft.	Alsjeblieft.
Ik smeek het je.	Ik smeek het je.
Laat het gaan.	Laat het gaan.
[vervormde stem] Rosa...	[vervormde stem] Rosa...
Hallo? -Blijf zitten...	Hallo? -Blijf zitten...
...als je nog interesse hebt.	...als je nog interesse hebt.
Yo. -Hé.	Yo. -Hé.
Je bent er nog.	Je bent er nog.
Ja.	Ja.
Ik moest toch blijven als ik interesse had?	Ik moest toch blijven als ik interesse had?
Oké, kap met deze geheimzinnige shit.	Oké, kap met deze geheimzinnige shit.
Serieus.	Serieus.
Zijn jullie koorballen met een museumjaarkaart?	Zijn jullie koorballen met een museumjaarkaart?
Wat?	Wat?
Wat is Ares? -[gelach]	Wat is Ares? -[gelach]
Wat?	Wat?
Hé, weet je wat?	Hé, weet je wat?
Laat maar. -Rosa...	Laat maar. -Rosa...
...ga zitten.	...ga zitten.
Heb je je nooit afgevraagd hoe het kan...	Heb je je nooit afgevraagd hoe het kan...
...dat zo'n klein landje als Nederland...	...dat zo'n klein landje als Nederland...
...zo rijk en machtig is geworden?	...zo rijk en machtig is geworden?
Rosa...	Rosa...
...wat wil je eigenlijk?	...wat wil je eigenlijk?
Ik doe zo mijn best.	Ik doe zo mijn best.
Ik probeer altijd tot 't uiterste te gaan.	Ik probeer altijd tot 't uiterste te gaan.
Maar...	Maar...
...ik denk dat ik even niet meer weet waar ik het voor doe.	...ik denk dat ik even niet meer weet waar ik het voor doe.
Mijn vader heeft me altijd opgevoed met keihard werken, maar...	Mijn vader heeft me altijd opgevoed met keihard werken, maar...
...voor wat?	...voor wat?
Er moet toch meer zijn dan dit.	Er moet toch meer zijn dan dit.
Wat wil jij?	Wat wil jij?
Winnen.	Winnen.
En ik weet dat ik 't in me heb.	En ik weet dat ik 't in me heb.
Ik moet zeker weten dat je dit aankan.	Ik moet zeker weten dat je dit aankan.
Ik moet zeker weten dat je er honderd procent voor gaat.	Ik moet zeker weten dat je er honderd procent voor gaat.
Weet je zeker dat je dit wil?	Weet je zeker dat je dit wil?
Joyce...	Joyce...
Joyce.	Joyce.
Joyce, hoor je me?	Joyce, hoor je me?
Joyce. Waar is Rosa?	Joyce. Waar is Rosa?

Ik voel me niet zo lekker.	Ik voel me niet zo lekker.
Ga je goed?	Ga je goed?
Even volhouden.	Even volhouden.
Gaat het? -[inademen] Ik vind het niet chill.	Gaat het? -[inademen] Ik vind het niet chill.
[zuchtje] Een van jullie hoort hier niet.	[zuchtje] Een van jullie hoort hier niet.
Jullie hebben twee minuten om te beslissen wie van jullie Ares moet verlaten. Succes.	Jullie hebben twee minuten om te beslissen wie van jullie Ares moet verlaten. Succes.
[zwaar ademen] Het lijkt me duidelijk.	[zwaar ademen] Het lijkt me duidelijk.
[Fleur] Ik ga wel.	[Fleur] Ik ga wel.
Ik meen 't. Ik wil echt naar huis.	Ik meen 't. Ik wil echt naar huis.
Oké, is goed.	Oké, is goed.
[inademen] Nou, ehm, opgelost, toch?	[inademen] Nou, ehm, opgelost, toch?
Stelletje indolente kutfeuten.	Stelletje indolente kutfeuten.
Luister, jouw pa, olie. En jij, farma.	Luister, jouw pa, olie. En jij, farma.
Ik weet dat jouw familie wapens dealt. De rest ken ik ook allemaal. En jou niet.	Ik weet dat jouw familie wapens dealt. De rest ken ik ook allemaal. En jou niet.
Dus, oprotten.	Dus, oprotten.
Opkankeren.	Opkankeren.
Waarom zouden we niet voor jou kiezen?	Waarom zouden we niet voor jou kiezen?
Nieuw geld, rattenkop. Ik zou je niet missen.	Nieuw geld, rattenkop. Ik zou je niet missen.
Mijn neef was vier jaar president.	Mijn neef was vier jaar president.
De president van Ares zit maar twee jaar.	De president van Ares zit maar twee jaar.
Mijn broer zit in de Senaat.	Mijn broer zit in de Senaat.
Nu jij weer.	Nu jij weer.
Laat je niet zo kennen, joh.	Laat je niet zo kennen, joh.
Het is een test.	Het is een test.
Ontgroeningen gaan altijd over saamhorigheid, toch?	Ontgroeningen gaan altijd over saamhorigheid, toch?
Dit is een test, om te kijken of we voor elkaar opkomen.	Dit is een test, om te kijken of we voor elkaar opkomen.
[halflachend] Jij hebt echt geen idee van what the fuck Ares is, hè?	[halflachend] Jij hebt echt geen idee van what the fuck Ares is, hè?
Wij blijven allemaal. [stilte]	Wij blijven allemaal. [stilte]
Niemand van ons gaat weg.	Niemand van ons gaat weg.
Christiaan Dhondt.	Christiaan Dhondt.
Vertel Beal uw grootste geheim.	Vertel Beal uw grootste geheim.
Het was donker.	Het was donker.
Ik had de [uitademen] koplampen nog uit staan. [uitademen]	Ik had de [uitademen] koplampen nog uit staan. [uitademen]
En voor ik 't wist stak er iemand over en toen... [schraapt keel] [inademen]	En voor ik 't wist stak er iemand over en toen... [schraapt keel] [inademen]
Ze was al dood voor iemand erbij kon komen. [uitademen]	Ze was al dood voor iemand erbij kon komen. [uitademen]
Hier bij Ares veroordelen we elkaar niet.	Hier bij Ares veroordelen we elkaar niet.
Ares dankt u voor uw eerlijkheid.	Ares dankt u voor uw eerlijkheid.
Jacob Krudop-Six.	Jacob Krudop-Six.
Uw familie heeft een rijke geschiedenis met dit genootschap.	Uw familie heeft een rijke geschiedenis met dit genootschap.
We hadden veel van u verwacht. Loyaliteit, boven alles.	We hadden veel van u verwacht. Loyaliteit, boven alles.
Ik, ehm... [slikt]	Ik, ehm... [slikt]
Ik weet niet... -U had 'n opdracht.	Ik weet niet... -U had 'n opdracht.
Een maand geleden kreeg u de taak om iemand voor ons te werven.	Een maand geleden kreeg u de taak om iemand voor ons te werven.
Gezien uw band met deze potentiële noviet, leek ons dit geen grote opgave.	Gezien uw band met deze potentiële noviet, leek ons dit geen grote opgave.
Maar u hebt uw taak verzuimd. [rumoer]	Maar u hebt uw taak verzuimd. [rumoer]
Sterker nog, u hebt er alles aan gedaan om haar bij ons weg te houden.	Sterker nog, u hebt er alles aan gedaan om haar bij ons weg te houden.
Ze hoort hier niet.	Ze hoort hier niet.
Als 'n ouderejaars u iets vraagt te doen, stel dan niet teleur, noviet Krudop-Six.	Als 'n ouderejaars u iets vraagt te doen, stel dan niet teleur, noviet Krudop-Six.
Rosa Steenwijk.	Rosa Steenwijk.
Weet je waarom Krudop-Six heeft verzuimd jou te vragen bij ons te komen?	Weet je waarom Krudop-Six heeft verzuimd jou te vragen bij ons te komen?
Misschien schaamt hij zich voor jullie.	Misschien schaamt hij zich voor jullie.
Of voor zichzelf.	Of voor zichzelf.
[Joost] Zichzelf?	[Joost] Zichzelf?
Ja. Dat denk ik.	Ja. Dat denk ik.
Dat hij Krudop-Six heet, hoor ik nu voor het eerst.	Dat hij Krudop-Six heet, hoor ik nu voor het eerst.
Ik hem al tien jaar als Jacob Wessels.	Ik hem al tien jaar als Jacob Wessels.
[Joost] Misschien schaamt hij zich voor jouw afkomst.	[Joost] Misschien schaamt hij zich voor jouw afkomst.
Waarom, noviet?	Waarom, noviet?
Omdat ik niet uit een rijke familie kom? Is dat het?	Omdat ik niet uit een rijke familie kom? Is dat het?
Omdat mijn moeder knettergek is? [stilte]	Omdat mijn moeder knettergek is? [stilte]
Omdat mijn vader nachtdienst draait?	Omdat mijn vader nachtdienst draait?
Ik lieg in ieder geval niet over mijn afkomst.	Ik lieg in ieder geval niet over mijn afkomst.
Hier bij Ares naaien we onze vrienden er niet bij, noviet.	Hier bij Ares naaien we onze vrienden er niet bij, noviet.
Je bent vrijwillig naar ons toe gekomen. Waarom? [stilte]	Je bent vrijwillig naar ons toe gekomen. Waarom? [stilte]
Wat heb je ons te bieden, noviet?	Wat heb je ons te bieden, noviet?
Waarom zouden wij jou toelaten?	Waarom zouden wij jou toelaten?
Tot gisteren wist ik niet eens dat jullie bestonden.	Tot gisteren wist ik niet eens dat jullie bestonden.
Maar ik schaam me nergens voor.	Maar ik schaam me nergens voor.
[stilte] Dus als jullie me willen hebben...	[stilte] Dus als jullie me willen hebben...
...hier ben ik.	...hier ben ik.
En zo niet...	En zo niet...
...ook prima. [slikt]	...ook prima. [slikt]
Dat ben ik gewend.	Dat ben ik gewend.
Niet zo kleinzerig.	Niet zo kleinzerig.
Een goede dokter is nooit weg.	Een goede dokter is nooit weg.
Ares dankt u voor uw eerlijkheid.	Ares dankt u voor uw eerlijkheid.
[Marije] Vorm 'n cirkel rond uw president.	[Marije] Vorm 'n cirkel rond uw president.
[Joost] Novieten van Ares, toon uw bondgenootschap...	[Joost] Novieten van Ares, toon uw bondgenootschap...
...via uw woord, uw daad...	...via uw woord, uw daad...
...en uw lichaam.	...en uw lichaam.
Wacht.	Wacht.
[stilte] We missen een noviet.	[stilte] We missen een noviet.
[man 1] Wat sta je nou te doen? Meekomen.	[man 1] Wat sta je nou te doen? Meekomen.
[man] Kom.	[man] Kom.
Er is elk jaar wel iemand die 't niet redt.	Er is elk jaar wel iemand die 't niet redt.
Gaat het?	Gaat het?
Jij kent die gast, toch?	Jij kent die gast, toch?
Ja, dat dacht ik ook, ja.	Ja, dat dacht ik ook, ja.
Ga je weer mee naar de zaal?	Ga je weer mee naar de zaal?
Kom.	Kom.
En wat-wat als ik dat niet wil?	En wat-wat als ik dat niet wil?
Nou goed...	Nou goed...
Maar...	Maar...
...als ik zo vrij mag zijn, hè, [lachje] waar wil je dan naar toe?	...als ik zo vrij mag zijn, hè, [lachje] waar wil je dan naar toe?
Gewoon naar huis.	Gewoon naar huis.
Jacob, je bent nu thuis.	Jacob, je bent nu thuis.
Dit is je nieuwe thuis.	Dit is je nieuwe thuis.
En wij zijn je familie. [stilte]	En wij zijn je familie. [stilte]
Alleen als je dat wil natuurlijk, hè, ik bedoel we dwingen je nergens toe.	Alleen als je dat wil natuurlijk, hè, ik bedoel we dwingen je nergens toe.
Ik snap 't, man, ik snap het. Het is ook, eh, confronterend. [slikt]	Ik snap 't, man, ik snap het. Het is ook, eh, confronterend. [slikt]
Je bent er net, moet je meteen zo'n masker op, al die mensen.	Je bent er net, moet je meteen zo'n masker op, al die mensen.
Het is ook heel spannend allemaal, zo'n ontgroening. [uitademen]	Het is ook heel spannend allemaal, zo'n ontgroening. [uitademen]
Je snapt toch dat 't allemaal theater is?	Je snapt toch dat 't allemaal theater is?
Traditie.	Traditie.
Je moet niet vergeten, het feit dat jij hier bent... [stilte]	Je moet niet vergeten, het feit dat jij hier bent... [stilte]
...dat is een privilege.	...dat is een privilege.
[stilte] Jij bent een Krudop-Six.	[stilte] Jij bent een Krudop-Six.
Net als je pa en als je broers. [stilte]	Net als je pa en als je broers. [stilte]
Jij hoort hier. [stilte]	Jij hoort hier. [stilte]
Hier. [stilte]	Hier. [stilte]
Dit is wie jij bent. [stilte]	Dit is wie jij bent. [stilte]
We moeten toch ergens het kaf van het koren scheiden, of niet?	We moeten toch ergens het kaf van het koren scheiden, of niet?
En jij bent het [inademen] k...	En jij bent het [inademen] k...
Koren...[slikt] -Koren. [stilte]	Koren...[slikt] -Koren. [stilte]
Juist.	Juist.
Mooie vent. [geeft schouderklopje]	Mooie vent. [geeft schouderklopje]
Niet vergeten, hè? Jij bent een topper. Kom.	Niet vergeten, hè? Jij bent een topper. Kom.
We hebben hem hier.	We hebben hem hier.
Oké, Jacob...	Oké, Jacob...
Rosa, meekomen, nu.	Rosa, meekomen, nu.
Wacht.	Wacht.
Wacht even.	Wacht even.
Wat doen we precies?	Wat doen we precies?
We zijn Jacob kwijt.	We zijn Jacob kwijt.
Echt kwijt.	Echt kwijt.
En ik dacht, misschien komt hij tevoorschijn als hij jouw stem hoort.	En ik dacht, misschien komt hij tevoorschijn als hij jouw stem hoort.
Is dit een test?	Is dit een test?
Is dit...	Is dit...
...zoek Jacob Wessels, of Krudop-Six?	...zoek Jacob Wessels, of Krudop-Six?
Nee, Rosa.	Nee, Rosa.
Ik meen het.	Ik meen het.
[inademen] Ik heb je hulp nodig.	[inademen] Ik heb je hulp nodig.
Roep hem maar.	Roep hem maar.
Toe maar.	Toe maar.
Jacob.	Jacob.
Jacob.	Jacob.
Jacob.	Jacob.
Jacob.	Jacob.
En?	En?
Niets?	Niets?
Nee.	Nee.
Doorzoek de westvleugel en stuur een groep naar de zolders.	Doorzoek de westvleugel en stuur een groep naar de zolders.
[Rosa] Jacob. -Geweldig, de zolders.	[Rosa] Jacob. -Geweldig, de zolders.
Steenwijk.	Steenwijk.
[Rosa] Jacob.	[Rosa] Jacob.
Jacob.	Jacob.
Ademen.	Ademen.
Ademen, ademen.	Ademen, ademen.
Goed zo.	Goed zo.
Wessels is de naam van m'n moeder.	Wessels is de naam van m'n moeder.
Waarom?	Waarom?
Je zal vast je redenen hebben gehad om te liegen over je achternaam.	Je zal vast je redenen hebben gehad om te liegen over je achternaam.
Het spijt me.	Het spijt me.
Waarom ben jij hier nog?	Waarom ben jij hier nog?
Omdat zij mij misschien wel goed genoeg vinden.	Omdat zij mij misschien wel goed genoeg vinden.
Ik wil dit niet. Au.	Ik wil dit niet. Au.
Ik kan heel goed zelf beslissen wat goed voor mij is of niet.	Ik kan heel goed zelf beslissen wat goed voor mij is of niet.
Heb je dat begrepen, Wessels?	Heb je dat begrepen, Wessels?
Ik red me wel.	Ik red me wel.
Ze kunnen nergens heen. Carmen?	Ze kunnen nergens heen. Carmen?
Sorry.	Sorry.
Ik denk dat jij wel weet hoe je dit goed moet maken.	Ik denk dat jij wel weet hoe je dit goed moet maken.
[Rosa] Ik heb hem gevonden.	[Rosa] Ik heb hem gevonden.
Roderick, neem ze mee.	Roderick, neem ze mee.
[Joost] Novieten van Ares.	[Joost] Novieten van Ares.
Toon uw bondgenootschap via uw woord...	Toon uw bondgenootschap via uw woord...
...uw daad en draag het teken met uw naaste.	...uw daad en draag het teken met uw naaste.
Beal ziet u.	Beal ziet u.
[stilte] Op de knieën.	[stilte] Op de knieën.
Toe maar.	Toe maar.
[angstkreetje] Niet doen, Arnold, niet doen.	[angstkreetje] Niet doen, Arnold, niet doen.
Stil zitten. Stil.	Stil zitten. Stil.
Rosa.	Rosa.
Gefeliciteerd. Welkom.	Gefeliciteerd. Welkom.
Thanks.	Thanks.
Jacob.	Jacob.
Gefeliciteerd.	Gefeliciteerd.
Hai.	Hai.
We zijn binnen, Steenwijk.	We zijn binnen, Steenwijk.
Ja. -We hebben 't gewoon gedaan.	Ja. -We hebben 't gewoon gedaan.
Ja. -We hebben 't gewoon geflikt.	Ja. -We hebben 't gewoon geflikt.
Thanks. -Ja.	Thanks. -Ja.
Het is gelukt.	Het is gelukt.
Hé.	Hé.
Wat een verrassing.	Wat een verrassing.
[Maurits] Wist je dat ons initiatieritueel nog veel ouder is dan Ares zelf?	[Maurits] Wist je dat ons initiatieritueel nog veel ouder is dan Ares zelf?
[lachje] Nee. Wist ik niet.	[lachje] Nee. Wist ik niet.
[Maurits] En?	[Maurits] En?
Hebben we er weer twaalf nieuwe discipelen bij?	Hebben we er weer twaalf nieuwe discipelen bij?
[zuchtend] Ja. Alles ging goed. Geen problemen.	[zuchtend] Ja. Alles ging goed. Geen problemen.
Joost, nu jij op ons niveau meedraait, eis ik absolute eerlijkheid.	Joost, nu jij op ons niveau meedraait, eis ik absolute eerlijkheid.
Hoe boos was het?	Hoe boos was het?
[inademen] Het was even wat onrustig beneden...	[inademen] Het was even wat onrustig beneden...
...maar je had gelijk. Het ritueel dat hielp enorm.	...maar je had gelijk. Het ritueel dat hielp enorm.
Ja.	Ja.
En zolang wij 't blijven voeden, is er niks aan de hand.	En zolang wij 't blijven voeden, is er niks aan de hand.
Hoe deed het meisje het? -Goed.	Hoe deed het meisje het? -Goed.
Ging goed.	Ging goed.
Gefeliciteerd met je eerste ontgroening, meneer de president.	Gefeliciteerd met je eerste ontgroening, meneer de president.


En?	En?
Alle novieten liggen in hun nieuwe kamers.	Alle novieten liggen in hun nieuwe kamers.
Ik heb je vader gesproken.	Ik heb je vader gesproken.
Wanneer? -Hij belde, of het goed was gegaan.	Wanneer? -Hij belde, of het goed was gegaan.
Alleen jammer van die ontsnapte noviet.	Alleen jammer van die ontsnapte noviet.
Dat was niet nodig, toch?	Dat was niet nodig, toch?
Dat gaat geen tweede keer gebeuren, hoor. Ik krijg 'm wel waar ik hem hebben wil.	Dat gaat geen tweede keer gebeuren, hoor. Ik krijg 'm wel waar ik hem hebben wil.
Hé, denk aan ons plan.	Hé, denk aan ons plan.
Ares op de eerste plaats, daarna...	Ares op de eerste plaats, daarna...
[fluistert] Wij.	[fluistert] Wij.
Wat doe jij nou?	Wat doe jij nou?
Oké.	Oké.
Nou, pak dan.	Nou, pak dan.
Dit ben ik niet.	Dit ben ik niet.
Mijn God, wie ben je dan? [zucht]	Mijn God, wie ben je dan? [zucht]
Hé, meiden.	Hé, meiden.
Hier zijn jullie.	Hier zijn jullie.
Je bent mooi.	Je bent mooi.
Hoe laat heb jij college? -Weet ik veel.	Hoe laat heb jij college? -Weet ik veel.
Eerst eens kijken wie er hier allemaal rondloopt...	Eerst eens kijken wie er hier allemaal rondloopt...
...en of er 'n beetje kwaliteit bij zit, als je begrijpt wat ik bedoel.	...en of er 'n beetje kwaliteit bij zit, als je begrijpt wat ik bedoel.
Hebben jullie je mobiel al terug?	Hebben jullie je mobiel al terug?
Hoezo? -Gewoon, ik wil even naar huis bellen.	Hoezo? -Gewoon, ik wil even naar huis bellen.
[lachen] Lieverd, je snapt het nog steeds niet, hè?	[lachen] Lieverd, je snapt het nog steeds niet, hè?
Nou, kom. Ze wachten.	Nou, kom. Ze wachten.
Wat zei hij? -[fluistert] Niks.	Wat zei hij? -[fluistert] Niks.
Oké.	Oké.
Zo, waar slapen jullie?	Zo, waar slapen jullie?
Wij zitten in de oostvleugel. Is prima te doen, joh.	Wij zitten in de oostvleugel. Is prima te doen, joh.
Jezus, is dit elke dag?	Jezus, is dit elke dag?
Ze is zenuwachtig. [slikt eten door] Ze heeft 'n feestje vanavond, hè, Borms?	Ze is zenuwachtig. [slikt eten door] Ze heeft 'n feestje vanavond, hè, Borms?
Ze gaat partyen bij een of andere arts. -Een neurochirurg.	Ze gaat partyen bij een of andere arts. -Een neurochirurg.
Hester de Hoogh?	Hester de Hoogh?
Gefeliciteerd.	Gefeliciteerd.
Als ik die plek niet had gekregen, had m'n broer had me de nek omgedraaid.	Als ik die plek niet had gekregen, had m'n broer had me de nek omgedraaid.
Is dat jouw broer? -Die linker. Arnold.	Is dat jouw broer? -Die linker. Arnold.
Gezellig type.	Gezellig type.
Studenten van Ares, vanaf vandaag verwelkomen wij...	Studenten van Ares, vanaf vandaag verwelkomen wij...
...een nieuwe selectie.	...een nieuwe selectie.
Ik kijk met trots naar de nieuwe leden...	Ik kijk met trots naar de nieuwe leden...
...die dit jaar gaan inluiden.	...die dit jaar gaan inluiden.
Beste novieten, dit is pas het begin.	Beste novieten, dit is pas het begin.
Dat gaan jullie zien.	Dat gaan jullie zien.
Ieder krijgt 'n eigen kamer.	Ieder krijgt 'n eigen kamer.
Jullie hebben een volledig nieuwe garderobe.	Jullie hebben een volledig nieuwe garderobe.
Wij zorgen voor jullie...	Wij zorgen voor jullie...
...kosten noch moeite.	...kosten noch moeite.
Ik hef het glas.	Ik hef het glas.
Op onze novieten. Op Ares.	Op onze novieten. Op Ares.
[in koor] Op Ares.	[in koor] Op Ares.
14 NIEUWE BERICHTEN PAPA 44 GEMISTE OPROEPEN	14 NIEUWE BERICHTEN PAPA 44 GEMISTE OPROEPEN
En waar denk jij heen te gaan? -Laat me erlangs. Er is 'n noodgeval.	En waar denk jij heen te gaan? -Laat me erlangs. Er is 'n noodgeval.
Een noodgeval? -Hé, ga opzij of ik beuk je.	Een noodgeval? -Hé, ga opzij of ik beuk je.
Wat gebeurt hier?	Wat gebeurt hier?
[inademen] Deze noviet kent haar plek niet.	[inademen] Deze noviet kent haar plek niet.
Nou, het is privé. -Er is niks privé bij Ares.	Nou, het is privé. -Er is niks privé bij Ares.
Kom.	Kom.
Welkom, Jacob [uitademen], ga zitten.	Welkom, Jacob [uitademen], ga zitten.
Wat is dit?	Wat is dit?
Waarom ben ik hier? -Ik begrijp dat jij wat twijfels hebt.	Waarom ben ik hier? -Ik begrijp dat jij wat twijfels hebt.
Of je hier wel wilt blijven.	Of je hier wel wilt blijven.
Ik stel je 'n aantal vragen en als jij snel en eerlijk antwoord geeft...	Ik stel je 'n aantal vragen en als jij snel en eerlijk antwoord geeft...
...proberen wij uit te zoeken wat het probleem is.	...proberen wij uit te zoeken wat het probleem is.
Het probleem? -En de oplossing.	Het probleem? -En de oplossing.
Zullen we het proberen?	Zullen we het proberen?
Je kan altijd je tas pakken en weggaan, als je dat nog wilt.	Je kan altijd je tas pakken en weggaan, als je dat nog wilt.
Deal?	Deal?
Ja.	Ja.
Ja, oké.	Ja, oké.
Rosa.	Rosa.
Wat heeft ze nou gedaan?	Wat heeft ze nou gedaan?
Het is goed mis.	Het is goed mis.
Probeer je hoofd leeg te maken.	Probeer je hoofd leeg te maken.
Antwoord zo snel als je kan.	Antwoord zo snel als je kan.
Wij betreden het onderbewuste van Jacob Krudop-Six.	Wij betreden het onderbewuste van Jacob Krudop-Six.
Wij eren de stroom, wij weren Beal.	Wij eren de stroom, wij weren Beal.
Jacob...	Jacob...
...ben je bang voor Ares?	...ben je bang voor Ares?
[lachje] Nee.	[lachje] Nee.
Ben je bang voor mij?	Ben je bang voor mij?
Weet ik veel. Eh, ja.	Weet ik veel. Eh, ja.
Ik ken je niet zo goed, toch?	Ik ken je niet zo goed, toch?
Wat is er precies gebeurd?	Wat is er precies gebeurd?
Weer een zelfmoordpoging.	Weer een zelfmoordpoging.
Weer d'r pols, deze keer in de keuken.	Weer d'r pols, deze keer in de keuken.
De hele vloer zat onder het bloed.	De hele vloer zat onder het bloed.
Je liet haar alleen.	Je liet haar alleen.
Papa...	Papa...
Mis je je moeder?	Mis je je moeder?
Nee.	Nee.
Haat je je vader? -Nee.	Haat je je vader? -Nee.
Waarom lieg je? -Ik lieg niet.	Waarom lieg je? -Ik lieg niet.
Jacob...	Jacob...
...we kunnen je alleen helpen als je helemaal eerlijk bent.	...we kunnen je alleen helpen als je helemaal eerlijk bent.
Voel je je eenzaam?	Voel je je eenzaam?
Soms. -Voel je je eenzaam nu?	Soms. -Voel je je eenzaam nu?
Ja. -Heb je geen vrienden?	Ja. -Heb je geen vrienden?
Eentje.	Eentje.
Rosa?	Rosa?
Ik heb vannacht weer dienst.	Ik heb vannacht weer dienst.
Als we straks thuiskomen, moet je helpen.	Als we straks thuiskomen, moet je helpen.
Je mag ons niet in de steek laten.	Je mag ons niet in de steek laten.
Je hebt een plicht. Begrijp je dat?	Je hebt een plicht. Begrijp je dat?
Waarom kom je niet voor jezelf op?	Waarom kom je niet voor jezelf op?
Omdat ik bang ben. -Waarvoor?	Omdat ik bang ben. -Waarvoor?
Falen. -Heb jij weleens suïcidale gedachtes?	Falen. -Heb jij weleens suïcidale gedachtes?
Hoe heb jij geprobeerd om zelfmoord te plegen?	Hoe heb jij geprobeerd om zelfmoord te plegen?
Waarom los jij je eigen problemen niet op?	Waarom los jij je eigen problemen niet op?
Ik weet 't niet. -Waarom accepteer je onze hulp niet?	Ik weet 't niet. -Waarom accepteer je onze hulp niet?
Weet ik niet. -Het is heel dapper om hulp te vragen.	Weet ik niet. -Het is heel dapper om hulp te vragen.
Jacob, waarom ben jij bang voor Ares?	Jacob, waarom ben jij bang voor Ares?
Mijn vader was lid [inademen]. -Zijn wij je vader?	Mijn vader was lid [inademen]. -Zijn wij je vader?
Nee. -Haat je je vader?	Nee. -Haat je je vader?
Ja. -Waarom accepteer je onze hulp niet?	Ja. -Waarom accepteer je onze hulp niet?
Ik weet het niet.	Ik weet het niet.
Hai. Ik ben Carmen.	Hai. Ik ben Carmen.
Vreselijk, dit.	Vreselijk, dit.
Ik weet het niet. Ik wil gewoon...	Ik weet het niet. Ik wil gewoon...
Ik wil gewoon een keer iets zelf kunnen.	Ik wil gewoon een keer iets zelf kunnen.
Rosa, kom.	Rosa, kom.
Ik wil gewoon dat het verandert.	Ik wil gewoon dat het verandert.
Wat wil je veranderen? -Gewoon, alles.	Wat wil je veranderen? -Gewoon, alles.
Mijn ouders. School.	Mijn ouders. School.
Alle mensen. Alles erbuiten.	Alle mensen. Alles erbuiten.
Alle bullshit, gewoon.	Alle bullshit, gewoon.
Ik wil gewoon opnieuw beginnen.	Ik wil gewoon opnieuw beginnen.
Ik wil gewoon opnieuw beginnen. [snik]	Ik wil gewoon opnieuw beginnen. [snik]
Daarom zijn we hier.	Daarom zijn we hier.
Rosa?	Rosa?
Rosa.	Rosa.
Waar wil je heen?	Waar wil je heen?
Hé, het is oké.	Hé, het is oké.
Zeg me, wat wil je?	Zeg me, wat wil je?
Naar huis.	Naar huis.
Wat is er met jou aan de hand?	Wat is er met jou aan de hand?
Niks.	Niks.
Waar ga je naartoe?	Waar ga je naartoe?
Je bedoelt: waar gaan wij naartoe?	Je bedoelt: waar gaan wij naartoe?
Je hebt mij verrast.	Je hebt mij verrast.
Oké.	Oké.
Je kan heel groot worden.	Je kan heel groot worden.
Ik ben blij dat je aan onze kant staat.	Ik ben blij dat je aan onze kant staat.
[mompelt] Ja.	[mompelt] Ja.
Nu die Rosa nog.	Nu die Rosa nog.
Die gaat na vanavond wel overstag.	Die gaat na vanavond wel overstag.
Hoe bedoel je?	Hoe bedoel je?
We weten 'n beetje hoe die feestjes bij De Hoogh zijn.	We weten 'n beetje hoe die feestjes bij De Hoogh zijn.
Dames, welkom. -Thanks.	Dames, welkom. -Thanks.
Ik ben blij om jullie te zien. Doe alsof je thuis bent.	Ik ben blij om jullie te zien. Doe alsof je thuis bent.
Nou, cheers dan.	Nou, cheers dan.
Proost.	Proost.
Ze was erg bescheiden.	Ze was erg bescheiden.
Nee, dat is niet waar.	Nee, dat is niet waar.
Hé. -Hé.	Hé. -Hé.
Mooi huis, heb je.	Mooi huis, heb je.
Ja. Dank je.	Ja. Dank je.
Rosa, toch?	Rosa, toch?
Ja. Rosa Steenwijk. -Hester.	Ja. Rosa Steenwijk. -Hester.
Leuk dat je er bent.	Leuk dat je er bent.
Ik wilde nog wat vra... -Steenwijk, van de West-Friese Steenwijks?	Ik wilde nog wat vra... -Steenwijk, van de West-Friese Steenwijks?
Nee.	Nee.
De familiebank, toch?	De familiebank, toch?
Nee, hij bedoelt: kennen we je ouders? [lachje]	Nee, hij bedoelt: kennen we je ouders? [lachje]
Nee, dat lijk me sterk. -Zat je moeder niet thuis met 'n psychose?	Nee, dat lijk me sterk. -Zat je moeder niet thuis met 'n psychose?
Doet dat ertoe? -Dat is vervelend om te horen.	Doet dat ertoe? -Dat is vervelend om te horen.
Doet het ertoe?	Doet het ertoe?
Ja, natuurlijk doet 't ertoe wat je ouders doen.	Ja, natuurlijk doet 't ertoe wat je ouders doen.
Het is heel modern... -Ik heb nagedacht over onze discussie.	Het is heel modern... -Ik heb nagedacht over onze discussie.
Het is waarom Ares al zo lang bestaat, hè. Vanwege...	Het is waarom Ares al zo lang bestaat, hè. Vanwege...
...tradities die doorgegeven worden. Van generatie op generatie.	...tradities die doorgegeven worden. Van generatie op generatie.
Nou, ik sta hier voor mezelf, en niet voor mijn ouders.	Nou, ik sta hier voor mezelf, en niet voor mijn ouders.
We staan hier allen als kinderen van onze ouders, schat.	We staan hier allen als kinderen van onze ouders, schat.
Of ben jij daar ook uniek in?	Of ben jij daar ook uniek in?
Doet het jou niks waar je vandaan komt? -Hé.	Doet het jou niks waar je vandaan komt? -Hé.
Kom.	Kom.
Laat je niet opjutten. Het is niks om je voor te schamen als je moeder...	Laat je niet opjutten. Het is niks om je voor te schamen als je moeder...
Ik schaam me nergens voor.	Ik schaam me nergens voor.
Oké.	Oké.
Geniet, hè?	Geniet, hè?
Ik ben heel slecht. -Heb je dat nodig?	Ik ben heel slecht. -Heb je dat nodig?
Jij bent niet op je mondje gevallen, hè?	Jij bent niet op je mondje gevallen, hè?
Die, eh, Arnold Borms, dat is natuurlijk gewoon een lul.	Die, eh, Arnold Borms, dat is natuurlijk gewoon een lul.
Zijn zusje is wel oké.	Zijn zusje is wel oké.
Misschien moet die maar vicepresident worden dan.	Misschien moet die maar vicepresident worden dan.
[uitblazen] Wie is dat?	[uitblazen] Wie is dat?
Fleur. Ze gaat stage lopen bij jou.	Fleur. Ze gaat stage lopen bij jou.
Oh. Ik ben niet zo goed met namen.	Oh. Ik ben niet zo goed met namen.
Heb je slaapgebrek?	Heb je slaapgebrek?
Tegen de zenuwen.	Tegen de zenuwen.
Kun je niet gebruiken in ons vak.	Kun je niet gebruiken in ons vak.
Ze denken dat wij een soort...	Ze denken dat wij een soort...
Ik weet niet. Dat we alles maar kunnen, dat we niks voelen.	Ik weet niet. Dat we alles maar kunnen, dat we niks voelen.
Dat we een soort übermensch zijn.	Dat we een soort übermensch zijn.
Wij zijn, eh, supermensen, zonder emotie.	Wij zijn, eh, supermensen, zonder emotie.
Niet doorvertellen, hè?	Niet doorvertellen, hè?
Ze vinden mij allemaal onethisch.	Ze vinden mij allemaal onethisch.
Soms moet je regels breken om grensverleggend te zijn.	Soms moet je regels breken om grensverleggend te zijn.
[uitblazen] Van wie is die? -Mezelf.	[uitblazen] Van wie is die? -Mezelf.
Maak je niet druk, Rosa.	Maak je niet druk, Rosa.
Jij komt er wel.	Jij komt er wel.
Jacob. -Hé.	Jacob. -Hé.
Ik kom eraan, ga maar.	Ik kom eraan, ga maar.
Ik had je toch gewaarschuwd, of niet?	Ik had je toch gewaarschuwd, of niet?
Maar toch ben je waar ik je niet wil zien. -Weet ik.	Maar toch ben je waar ik je niet wil zien. -Weet ik.
Hé.	Hé.
Blik op mij, noviet. -[fluistert] Ja.	Blik op mij, noviet. -[fluistert] Ja.
Hé. Blik op mij, oké?	Hé. Blik op mij, oké?
Sorry. [stottert] Ik ga er gewoon vandoor.	Sorry. [stottert] Ik ga er gewoon vandoor.
Hé.	Hé.
Sinds wanneer heb je die vingers?	Sinds wanneer heb je die vingers?
Wat doe je?	Wat doe je?
Rosa, waar was je?	Rosa, waar was je?
Ik heb je overal gezocht.	Ik heb je overal gezocht.
Ken je Machteld?	Ken je Machteld?
Machteld en ik hebben vorig jaar Saint-Tropez helemaal gek gemaakt.	Machteld en ik hebben vorig jaar Saint-Tropez helemaal gek gemaakt.
Ze heeft de beste pillen van het Westelijk halfrond.	Ze heeft de beste pillen van het Westelijk halfrond.
Neem maar.	Neem maar.
[lachend] Nee, thanks. Oké. -[lachen] Jawel, toe maar.	[lachend] Nee, thanks. Oké. -[lachen] Jawel, toe maar.
Goed zo.	Goed zo.
[kust Rosa op wang] Zie je zo.	[kust Rosa op wang] Zie je zo.
Kan ik jou alsjeblieft even spreken?	Kan ik jou alsjeblieft even spreken?
Wat? -Kan ik je alsjeblieft even spreken?	Wat? -Kan ik je alsjeblieft even spreken?
Alsjeblieft. Nu.	Alsjeblieft. Nu.
Kom, liggen.	Kom, liggen.
Wat doe jij hier?	Wat doe jij hier?
Heb jij Rosa gezien?	Heb jij Rosa gezien?
We moeten hier weg. Nu.	We moeten hier weg. Nu.
Jezus, Jacob. Is alles oké?	Jezus, Jacob. Is alles oké?
Nee. Nee, het is niet oké. -Wat is er aan de hand?	Nee. Nee, het is niet oké. -Wat is er aan de hand?
Ik heb vannacht iets gezien, iets onder Ares.	Ik heb vannacht iets gezien, iets onder Ares.
We waren allemaal zwaar naar de klote, Jacob.	We waren allemaal zwaar naar de klote, Jacob.
Ik heb ook dingen gezien.	Ik heb ook dingen gezien.
[fluistert] Waar is ze?	[fluistert] Waar is ze?
Waar is Rosa?	Waar is Rosa?
Zeg het me. Zeg het.	Zeg het me. Zeg het.
Je moet 't vertellen. Je moet me helpen. -Ik weet 't niet.	Je moet 't vertellen. Je moet me helpen. -Ik weet 't niet.
Liefje?	Liefje?
Zullen we zo gaan?	Zullen we zo gaan?
Ja.	Ja.
Hé. -Hé.	Hé. -Hé.
Ben jij er ook nog? -Ja, met...	Ben jij er ook nog? -Ja, met...
Maakt mij niet uit, hè?	Maakt mij niet uit, hè?
Nou, ga je even lekker douchen? -Ja.	Nou, ga je even lekker douchen? -Ja.
Zie ik je snel. -Thanks.	Zie ik je snel. -Thanks.
Jacob?	Jacob?
Ondertiteld door: Willem Siers	Ondertiteld door: Willem Siers

Hallo, Rosa.	Hallo, Rosa.
Lodewijk de Leeuw, kom je met me mee?	Lodewijk de Leeuw, kom je met me mee?
[stilte] Jij ook, Jacob?	[stilte] Jij ook, Jacob?
[man] Mr. Borms.	[man] Mr. Borms.
Hoe gaat het?	Hoe gaat het?
Papa komt.	Papa komt.
Maurits Zwanenburg.	Maurits Zwanenburg.
Vader van Carmen.	Vader van Carmen.
Rosa.	Rosa.
Gecondoleerd. -Gecondoleerd.	Gecondoleerd. -Gecondoleerd.
Jongens.	Jongens.
Goed, welkom.	Goed, welkom.
Ik begrijp dat dit erg moeilijk is.	Ik begrijp dat dit erg moeilijk is.
Het is nog heel vers.	Het is nog heel vers.
Maar wat is er gebeurd?	Maar wat is er gebeurd?
Het leek een geslaagd feest. [inademen]	Het leek een geslaagd feest. [inademen]
Er waren ook helemaal geen incidenten of zo.	Er waren ook helemaal geen incidenten of zo.
Ook geen indicatie dat ie iets aan zichzelf...	Ook geen indicatie dat ie iets aan zichzelf...
[Maurits] Geen afscheidsbrief, toch? -[Hester] Nee.	[Maurits] Geen afscheidsbrief, toch? -[Hester] Nee.
Wie van jullie heeft hem als laatste gezien?	Wie van jullie heeft hem als laatste gezien?
Ik... Ik was ergens anders.	Ik... Ik was ergens anders.
Waren er drugs in het spel?	Waren er drugs in het spel?
Ik heb hem zelf niet iets zien nemen, dus misschien jullie, maar...	Ik heb hem zelf niet iets zien nemen, dus misschien jullie, maar...
[Maurits] Wat er in iemands hoofd omgaat op zo'n moment...	[Maurits] Wat er in iemands hoofd omgaat op zo'n moment...
Ik vrees dat we moeten accepteren dat we het nooit echt zullen weten.	Ik vrees dat we moeten accepteren dat we het nooit echt zullen weten.
[Lodewijk] Mmm.	[Lodewijk] Mmm.
Ja? Dus, even praktisch. Hoe gaan we dit aanpakken?	Ja? Dus, even praktisch. Hoe gaan we dit aanpakken?
[Lodewijk] Informatie weghouden bij de leden.	[Lodewijk] Informatie weghouden bij de leden.
Ja, vooral de studenten. -En de ouders...	Ja, vooral de studenten. -En de ouders...
Als die te weten komen dat dit weer een zelfmoord was...	Als die te weten komen dat dit weer een zelfmoord was...
We houden het binnen deze kamer.	We houden het binnen deze kamer.
Voor hun eigen bestwil.	Voor hun eigen bestwil.
Henry, zorg jij voor je zus.	Henry, zorg jij voor je zus.
Zijn ouders zijn onderweg...	Zijn ouders zijn onderweg...
...en die willen het lichaam zien.	...en die willen het lichaam zien.
Roderick.	Roderick.
Jij bent vicepresident, heb je ideeën?	Jij bent vicepresident, heb je ideeën?
Eh...	Eh...
Een ongeluk?	Een ongeluk?
Ga door.	Ga door.
Eh...	Eh...
Hij viel van de trap...	Hij viel van de trap...
...brak zijn nek.	...brak zijn nek.
Er waren getuigen.	Er waren getuigen.
Nee, dat betekent dat het nog steeds in mijn huis is.	Nee, dat betekent dat het nog steeds in mijn huis is.
Ik vind dat gedoe.	Ik vind dat gedoe.
Dat is gedoe.	Dat is gedoe.
Ja... -[inademen] Dat doen we niet.	Ja... -[inademen] Dat doen we niet.
Jacob, ik heb jou nog niet gehoord.	Jacob, ik heb jou nog niet gehoord.
Wat vind jij van de opties?	Wat vind jij van de opties?
Een ongeluk?	Een ongeluk?
Het was geen ongeluk... -Hè?	Het was geen ongeluk... -Hè?
Mr. Zwanenburg probeert te helpen.	Mr. Zwanenburg probeert te helpen.
Jullie waren zwaar onder invloed en 't is op 'n onvoordelige locatie gebeurd.	Jullie waren zwaar onder invloed en 't is op 'n onvoordelige locatie gebeurd.
Precies.	Precies.
Hoe pakken we dat aan?	Hoe pakken we dat aan?
We hebben hem levend zien vertrekken.	We hebben hem levend zien vertrekken.
Dat is wat jullie willen horen toch?	Dat is wat jullie willen horen toch?
Dat we zeggen dat ie ergens anders is doodgegaan.	Dat we zeggen dat ie ergens anders is doodgegaan.
Wij moeten liegen, daar gaat het om.	Wij moeten liegen, daar gaat het om.
We willen een betere werkelijkheid voor iedereen, Rosa.	We willen een betere werkelijkheid voor iedereen, Rosa.
[Lodewijk] Goed.	[Lodewijk] Goed.
Een ongeluk.	Een ongeluk.
Het moet snel, helaas.	Het moet snel, helaas.
Hebben we hier geen mensen voor?	Hebben we hier geen mensen voor?
Wij doen dit samen, voor Joost.	Wij doen dit samen, voor Joost.
Rosa.	Rosa.
Wat stel je voor?	Wat stel je voor?
Deze jongen heeft een zwaar auto-ongeluk gehad.	Deze jongen heeft een zwaar auto-ongeluk gehad.
Wat voor verwondingen heb je dan?	Wat voor verwondingen heb je dan?
Jij wordt arts, toch?	Jij wordt arts, toch?
Nou, kom op... Hier, op zijn borst, waar?	Nou, kom op... Hier, op zijn borst, waar?
Eh...	Eh...
Verwondingen aan het gezicht.	Verwondingen aan het gezicht.
Zijn borst.	Zijn borst.
Botbreuken.	Botbreuken.
Zijn gezicht.	Zijn gezicht.
Zijn hoofd, dus.	Zijn hoofd, dus.
Toch?	Toch?
Oké, kom op, Ro. Nu jij. Zijn ouders komen eraan.	Oké, kom op, Ro. Nu jij. Zijn ouders komen eraan.
Ik weet het jongen, doe maar.	Ik weet het jongen, doe maar.
Ro, wacht.	Ro, wacht.
Ik wil dat de noviet het afmaakt.	Ik wil dat de noviet het afmaakt.
[Roderick] Gecondoleerd.	[Roderick] Gecondoleerd.
Gecondoleerd.	Gecondoleerd.
U ook gecondoleerd. -Dank je wel.	U ook gecondoleerd. -Dank je wel.
Nogmaals, Lilian, Dolf.	Nogmaals, Lilian, Dolf.
Wat tragisch dat we elkaar onder deze omstandigheden moeten treffen.	Wat tragisch dat we elkaar onder deze omstandigheden moeten treffen.
De leegte die Joost achterlaat is onvoorstelbaar.	De leegte die Joost achterlaat is onvoorstelbaar.
Zeker voor degenen van ons die hem het beste hebben gekend.	Zeker voor degenen van ons die hem het beste hebben gekend.
Maar samen slaan we ons hier doorheen.	Maar samen slaan we ons hier doorheen.
Lilian, Dolf, Carmen...	Lilian, Dolf, Carmen...
...Ares is er voor jullie.	...Ares is er voor jullie.
Het is dan ook vanzelfsprekend dat wij met zijn allen...	Het is dan ook vanzelfsprekend dat wij met zijn allen...
...het glas heffen op de prestaties van Joost, op het leven van Joost.	...het glas heffen op de prestaties van Joost, op het leven van Joost.
[Lilian] Wacht.	[Lilian] Wacht.
Lilian...	Lilian...
Ik wil het weten.	Ik wil het weten.
Hoe is het gebeurd?	Hoe is het gebeurd?
Wat is er met mijn jongen gebeurd?	Wat is er met mijn jongen gebeurd?
Dit is niet het moment om 't intieme vertrouwen binnen Ares te schenden.	Dit is niet het moment om 't intieme vertrouwen binnen Ares te schenden.
[Rosa] Het was een ongeluk.	[Rosa] Het was een ongeluk.
Ik was erbij.	Ik was erbij.
Joost was...	Joost was...
...dronken dus hij wilde naar huis lopen.	...dronken dus hij wilde naar huis lopen.
Hij zwalkte over straat en...	Hij zwalkte over straat en...
[zuchtje] Ik heb echt geprobeerd hem tegen te houden, maar toen hij overstak...	[zuchtje] Ik heb echt geprobeerd hem tegen te houden, maar toen hij overstak...
...kwam er een vrachtwagen en werd hij geschept.	...kwam er een vrachtwagen en werd hij geschept.
Hij kwam tussen de wielen... -Hij was op slag dood.	Hij kwam tussen de wielen... -Hij was op slag dood.
Heeft hij er iets van gevoeld?	Heeft hij er iets van gevoeld?
[snikje] Nee. -Nee.	[snikje] Nee. -Nee.
Laten we, het glas heffen...	Laten we, het glas heffen...
...op 't leven van Joost van Moerland.	...op 't leven van Joost van Moerland.
Hij was onze president...	Hij was onze president...
...en hij vervulde die leidersrol met verve.	...en hij vervulde die leidersrol met verve.
Joost was iemand die alles gaf.	Joost was iemand die alles gaf.
Iemand die zichzelf opzij zette voor het grotere goed.	Iemand die zichzelf opzij zette voor het grotere goed.
Hij zette zich in voor onze waarden...	Hij zette zich in voor onze waarden...
...hij verdedigde onze overtuigingen...	...hij verdedigde onze overtuigingen...
...hij bewaakte onze toekomst.	...hij bewaakte onze toekomst.
Leiders als Joost zorgen er al eeuwen voor...	Leiders als Joost zorgen er al eeuwen voor...
...dat ons genootschap sterk blijft.	...dat ons genootschap sterk blijft.
Dat het kan voortbestaan. De offers die zij brengen...	Dat het kan voortbestaan. De offers die zij brengen...
...zijn voor ons allemaal een voorbeeld.	...zijn voor ons allemaal een voorbeeld.
En in hun schaduw volgen wij allemaal hun voorbeeld.	En in hun schaduw volgen wij allemaal hun voorbeeld.
Op Ares.	Op Ares.
[allen] Op Ares.	[allen] Op Ares.
[Maurits] En op Joost.	[Maurits] En op Joost.
Een geliefde...	Een geliefde...
...een vriend...	...een vriend...
...een leider.	...een leider.
[geroezemoes] -[Maurits] Rosa.	[geroezemoes] -[Maurits] Rosa.
Dank je...	Dank je...
...voor eh...	...voor eh...
Voor daarnet.	Voor daarnet.
[Hester] Ja.	[Hester] Ja.
Ik ben onder de indruk.	Ik ben onder de indruk.
Je bent goed.	Je bent goed.
Mag ik jou heel hartelijk danken...	Mag ik jou heel hartelijk danken...
Namens heel Ares. -Nou, dank.	Namens heel Ares. -Nou, dank.
Denk maar niet dat het voor niets was.	Denk maar niet dat het voor niets was.
Jij wilt hier iets voor terug?	Jij wilt hier iets voor terug?
Absoluut.	Absoluut.
Hoe is het met je hand?	Hoe is het met je hand?
Laat zien.	Laat zien.
Wat ben je aan het doen?	Wat ben je aan het doen?
Nou, kom op, laat zien. -Wat heb je gedaan?	Nou, kom op, laat zien. -Wat heb je gedaan?
Rosa, we moeten hier weg, jij moet hier weg.	Rosa, we moeten hier weg, jij moet hier weg.
Jacob, kom op...	Jacob, kom op...
Als we op Ares zijn, pakken we onze spullen en dan gaan we.	Als we op Ares zijn, pakken we onze spullen en dan gaan we.
En dan? Moet ik dan terug naar huis?	En dan? Moet ik dan terug naar huis?
Dat is lekker makkelijk lullen met 'n zilveren lepel in je bek.	Dat is lekker makkelijk lullen met 'n zilveren lepel in je bek.
Roos...	Roos...
Jacob Krudop-Six.	Jacob Krudop-Six.
Ik ga niet de kans van mijn leven weggooien...	Ik ga niet de kans van mijn leven weggooien...
...alleen maar omdat jij fucking jaloers op me bent.	...alleen maar omdat jij fucking jaloers op me bent.
[Rosa] Hé...	[Rosa] Hé...
Hé, Fleur.	Hé, Fleur.
Gaat het?	Gaat het?
Hester wil me niet meer [snik] als haar assistent.	Hester wil me niet meer [snik] als haar assistent.
Ze zei net...	Ze zei net...
Ze zei...	Ze zei...
Maar je broer is nu toch president?	Maar je broer is nu toch president?
Er zijn nog genoeg kansen voor jou, toch?	Er zijn nog genoeg kansen voor jou, toch?
Ze zei dat jij mijn plek nu hebt.	Ze zei dat jij mijn plek nu hebt.
Dus?	Dus?
De beste wint.	De beste wint.
Kankerhoer. -[deur gaat open]	Kankerhoer. -[deur gaat open]
Wat is er met jou?	Wat is er met jou?
[hijgen] Ik voel met niet zo lekker.	[hijgen] Ik voel met niet zo lekker.
Meen je dit?	Meen je dit?
[Rosa] Wat gebeurt er met me?	[Rosa] Wat gebeurt er met me?
[Carmen] Toe maar.	[Carmen] Toe maar.
Toe maar.	Toe maar.
Laat het maar komen. Hou het niet tegen. Loslaten.	Laat het maar komen. Hou het niet tegen. Loslaten.
Je doet het heel goed.	Je doet het heel goed.
Heel goed.	Heel goed.
Goed zo. -[hoesten]	Goed zo. -[hoesten]
Wat is dit?	Wat is dit?
Nee...	Nee...
...doe maar niet.	...doe maar niet.
Hoe voel je je?	Hoe voel je je?
[ademen] Prima.	[ademen] Prima.
[Arnold] Jacob.	[Arnold] Jacob.
Ben je... Oké?	Ben je... Oké?
Ik ben trots op je, man.	Ik ben trots op je, man.
Ik had niet verwacht dat je 't zou doen, maar ik...	Ik had niet verwacht dat je 't zou doen, maar ik...
Ik geef toe dat ik fout zat.	Ik geef toe dat ik fout zat.
Kom.	Kom.
Geef je nieuwe president een hand...	Geef je nieuwe president een hand...
...noviet.	...noviet.
Weet je het zeker?	Weet je het zeker?
Kom.	Kom.
Ik doe je niks. Laatst in de keuken dat was nodig om je...	Ik doe je niks. Laatst in de keuken dat was nodig om je...
Hallo?	Hallo?
Hé, dit is, eh...	Hé, dit is, eh...
Dit is echt niet grappig.	Dit is echt niet grappig.
Au.	Au.
Ik heb hier zo lang op gewacht.	Ik heb hier zo lang op gewacht.
[kreet] Arnold.	[kreet] Arnold.
[man] U heeft Ares...	[man] U heeft Ares...
...de ultieme trouw getoond.	...de ultieme trouw getoond.
Beal is bereid uw zonden op zich te nemen.	Beal is bereid uw zonden op zich te nemen.
Arnold Borms...	Arnold Borms...
...offer Beal...	...offer Beal...
...uw ziel.	...uw ziel.
Fuck.	Fuck.

Bravo, Maurits.	Bravo, Maurits.
Ik trof haar aan op de toiletten.	Ik trof haar aan op de toiletten.
Het kwam onverwacht, maar het was best veel.	Het kwam onverwacht, maar het was best veel.
Maar ik heb m'n twijfels of ze al klaar is voor de volgende stap.	Maar ik heb m'n twijfels of ze al klaar is voor de volgende stap.
Steenwijk is 'n eerstejaars.	Steenwijk is 'n eerstejaars.
Waarom zouden we haar privileges geven die alleen voor ouderejaars gelden?	Waarom zouden we haar privileges geven die alleen voor ouderejaars gelden?
Helena.	Helena.
Dat is een hele domme zet. [pauze] Denk eens na.	Dat is een hele domme zet. [pauze] Denk eens na.
Is het bewaard gebleven?	Is het bewaard gebleven?
Ja. [pauze] Bijna alles.	Ja. [pauze] Bijna alles.
Mooi. -[klop op deur]	Mooi. -[klop op deur]
Kom je?	Kom je?
Hier.	Hier.
Dit is een privilege.	Dit is een privilege.
Niet kwijtraken.	Niet kwijtraken.
Toe maar.	Toe maar.
Zo is 't goed.	Zo is 't goed.
Wat gebeurt ermee?	Wat gebeurt ermee?
Voordat je misselijk werd...	Voordat je misselijk werd...
...voelde je je toen schuldig?	...voelde je je toen schuldig?
Waarover? -Dat vraag ik.	Waarover? -Dat vraag ik.
En nu? [pauze] Hoe voel je je nu?	En nu? [pauze] Hoe voel je je nu?
Ik voel niks. Ik [stotter] voel me normaal.	Ik voel niks. Ik [stotter] voel me normaal.
Dit [inademing] is wat aan je vreet.	Dit [inademing] is wat aan je vreet.
Waar je van wakker ligt.	Waar je van wakker ligt.
Die knoop in je maag.	Die knoop in je maag.
Je hoeft niet schuldig te voelen omdat je kiest wat het beste voor je is.	Je hoeft niet schuldig te voelen omdat je kiest wat het beste voor je is.
Bewaar deze in je kast, voor als je 's nachts wil offeren.	Bewaar deze in je kast, voor als je 's nachts wil offeren.
Offeren?	Offeren?
Als ik je nu alles vertel, zou je het niet begrijpen.	Als ik je nu alles vertel, zou je het niet begrijpen.
Ik begrijp een hoop.	Ik begrijp een hoop.
Rosa...	Rosa...
Wil je het niet zeggen of weet je het niet?	Wil je het niet zeggen of weet je het niet?
Ze is een noviet, hè.	Ze is een noviet, hè.
Ik ben op de hoogte.	Ik ben op de hoogte.
Ja, maakt mij niet uit hoor, maar...	Ja, maakt mij niet uit hoor, maar...
Er staat 'n auto op je te wachten.	Er staat 'n auto op je te wachten.
Ik kom eraan. -Nee.	Ik kom eraan. -Nee.
Voor Steenwijk.	Voor Steenwijk.
Arnold.	Arnold.
Arnold.	Arnold.
Vier je zo je eerste dag?	Vier je zo je eerste dag?
Heb je gehoord wat ze gedaan heeft?	Heb je gehoord wat ze gedaan heeft?
Ze is nu haar favoriet.	Ze is nu haar favoriet.
Het was mijn stageplaats.	Het was mijn stageplaats.
Rosa heeft daar helemaal geen recht op.	Rosa heeft daar helemaal geen recht op.
Ze komt niet uit een Aresfamilie.	Ze komt niet uit een Aresfamilie.
Ze kent onze geschiedenis niet. Ze is niemand.	Ze kent onze geschiedenis niet. Ze is niemand.
Jij kan dit nu voor mij regelen, toch?	Jij kan dit nu voor mij regelen, toch?
Haar wegkrijgen.	Haar wegkrijgen.
Hé.	Hé.
Het spijt me [uitademen]. -Het spijt je?	Het spijt me [uitademen]. -Het spijt je?
Jij moet dit oplossen.	Jij moet dit oplossen.
Jezus, man. Je stinkt.	Jezus, man. Je stinkt.
What the fuck is er met jou aan de hand?	What the fuck is er met jou aan de hand?
Wat moet je?	Wat moet je?
Wat doe je?	Wat doe je?
Het spijt me.	Het spijt me.
Je bent dronken, man.	Je bent dronken, man.
Het spijt me.	Het spijt me.
[halfhuilend] Het spijt me zo. -Hé, laat me los.	[halfhuilend] Het spijt me zo. -Hé, laat me los.
Het spijt me. Het spijt me. [kreun] -Laat me los.	Het spijt me. Het spijt me. [kreun] -Laat me los.
Het spijt me. -Laat me los.	Het spijt me. -Laat me los.
Rosa Steenwijk?	Rosa Steenwijk?
Hoi.	Hoi.
[via luidspreker, in Engels] So, I'm now inserting the DBS.	[via luidspreker, in Engels] So, I'm now inserting the DBS.
Ga maar zitten.	Ga maar zitten.
A probe, electronic on the...	A probe, electronic on the...
...subthalamic nucleus.	...subthalamic nucleus.
Oké.	Oké.
And this causes enormous improvement...	And this causes enormous improvement...
...on the treatment...	...on the treatment...
...from baseline up to PDQ40.	...from baseline up to PDQ40.
Is mijn nieuwe assistent er al?	Is mijn nieuwe assistent er al?
Rosa [pauze] ben je daar?	Rosa [pauze] ben je daar?
Rosa?	Rosa?
Sorry.	Sorry.
Sorry. Sorry.	Sorry. Sorry.
Sorry.	Sorry.
Sorry.	Sorry.
[Hester] Ja, ik moet deze nog afstellen.	[Hester] Ja, ik moet deze nog afstellen.
Doe jij die platte, Geert?	Doe jij die platte, Geert?
Hé, welkom.	Hé, welkom.
Hé.	Hé.
[Hester] Oké, Hans, we zijn er bijna. Je kunt weer starten.	[Hester] Oké, Hans, we zijn er bijna. Je kunt weer starten.
Ja, en goed dat ritme vasthouden, hè?	Ja, en goed dat ritme vasthouden, hè?
Kom maar, hoor.	Kom maar, hoor.
Kom maar zitten.	Kom maar zitten.
Ja, deze patiënt heeft dus een vroeg stadium van Parkinson.	Ja, deze patiënt heeft dus een vroeg stadium van Parkinson.
En dat gaan we verhelpen met elektroden.	En dat gaan we verhelpen met elektroden.
Eh, kom maar even met je hand.	Eh, kom maar even met je hand.
Ho. Dit is ver boven mijn verantwoordelijkheid als stagiair.	Ho. Dit is ver boven mijn verantwoordelijkheid als stagiair.
[lachje] Ik begeleid je toch?	[lachje] Ik begeleid je toch?
Eh, ja, Eef, zet 'm maar even uit.	Eh, ja, Eef, zet 'm maar even uit.
Niemand kijkt mee.	Niemand kijkt mee.
Gaan we. Hou hem vast.	Gaan we. Hou hem vast.
Daar gaan we, Hans.	Daar gaan we, Hans.
En verder? Hoe bevalt je kamer? Voel je je al thuis?	En verder? Hoe bevalt je kamer? Voel je je al thuis?
Nou...	Nou...
...sommige dingen daar zijn niet standaard, als je snapt wat ik bedoel.	...sommige dingen daar zijn niet standaard, als je snapt wat ik bedoel.
Maar...	Maar...
Ik hoor dat het al gebeurd is.	Ik hoor dat het al gebeurd is.
Het geven.	Het geven.
Dat is juist goed, hè.	Dat is juist goed, hè.
Maar eh... Hoe vond je het?	Maar eh... Hoe vond je het?
Nou, ik weet niet...	Nou, ik weet niet...
Wel oké, [lachend] geloof ik.	Wel oké, [lachend] geloof ik.
Het is ook een beetje raar, hè? [pauze] Maar dat went dus.	Het is ook een beetje raar, hè? [pauze] Maar dat went dus.
En kijk hoe je hier nu staat. [klakje met tong] Ta-da.	En kijk hoe je hier nu staat. [klakje met tong] Ta-da.
Hester? -Ja.	Hester? -Ja.
Nou... Vertel morgen meer, want ik wil alles weten.	Nou... Vertel morgen meer, want ik wil alles weten.
Morgen? Begin ik morgen al?	Morgen? Begin ik morgen al?
Ja, tenzij je liever naar college gaat.	Ja, tenzij je liever naar college gaat.
Je bent hier helemaal op eigen houtje gekomen.	Je bent hier helemaal op eigen houtje gekomen.
Dus wees daar trots op.	Dus wees daar trots op.
Nou, ik ben hier vooral omdat ik Fleur Borms erbij heb genaaid.	Nou, ik ben hier vooral omdat ik Fleur Borms erbij heb genaaid.
Borms had het hier prima gedaan.	Borms had het hier prima gedaan.
Maar ze mist iets, wat jij wel hebt.	Maar ze mist iets, wat jij wel hebt.
En dat is?	En dat is?
Ambitie.	Ambitie.
Tot morgen.	Tot morgen.
Hé.	Hé.
Hé.	Hé.
Jacob...	Jacob...
Ik weet dat je veel van m'n keuzes niet snapt.	Ik weet dat je veel van m'n keuzes niet snapt.
Maar ik weet waar ik het voor doe.	Maar ik weet waar ik het voor doe.
Zeg wat.	Zeg wat.
Gefeliciteerd.	Gefeliciteerd.
Laat maar. Welterusten.	Laat maar. Welterusten.
Ik krijg hier kansen die ik daarbuiten nog nooit heb gehad.	Ik krijg hier kansen die ik daarbuiten nog nooit heb gehad.
Ja.	Ja.
Dat is inderdaad wat ze willen dat je denkt.	Dat is inderdaad wat ze willen dat je denkt.
Fuck jou, Jacob.	Fuck jou, Jacob.
Ik werk hier fucking hard voor. Jij weet niet eens wat dat is.	Ik werk hier fucking hard voor. Jij weet niet eens wat dat is.
Wat doe je?	Wat doe je?
Moet je nou eens kijken wat ze van je aan het maken zijn.	Moet je nou eens kijken wat ze van je aan het maken zijn.
Maar, Roos, ik ga alles veranderen.	Maar, Roos, ik ga alles veranderen.
Ik ga Ares voorgoed veranderen.	Ik ga Ares voorgoed veranderen.
Ga naar huis. Voordat we echt ruzie krijgen.	Ga naar huis. Voordat we echt ruzie krijgen.
Hij was anders.	Hij was anders.
Niet meer zichzelf.	Niet meer zichzelf.
Je denkt vast dat ik gek ben.	Je denkt vast dat ik gek ben.
Nee, hoor. Helemaal niet.	Nee, hoor. Helemaal niet.
Jij maakt je gewoon zorgen om je vriend.	Jij maakt je gewoon zorgen om je vriend.
Wat?	Wat?
Je zei iets over zijn vingers.	Je zei iets over zijn vingers.
Ja.	Ja.
Die zijn zwart.	Die zijn zwart.
We kunnen hem verwijderen.	We kunnen hem verwijderen.
Dat kan. Dat is een mogelijkheid.	Dat kan. Dat is een mogelijkheid.
Verwijderen?	Verwijderen?
Je hebt een uitdagend jaar voor de boeg.	Je hebt een uitdagend jaar voor de boeg.
Dan kan je geen blok aan je been gebruiken.	Dan kan je geen blok aan je been gebruiken.
Jacob is geen blok aan m'n been. -Nee?	Jacob is geen blok aan m'n been. -Nee?
Wil je hem weg hebben?	Wil je hem weg hebben?
Ja of nee?	Ja of nee?
De voicemail van Maurits Zwanenburg, Atlantic Oil. Berichten na de toon.	De voicemail van Maurits Zwanenburg, Atlantic Oil. Berichten na de toon.
Maurits, met Hester.	Maurits, met Hester.
Ik denk dat ik iets heb over...	Ik denk dat ik iets heb over...
...de zelfmoord van Joost van Moerland.	...de zelfmoord van Joost van Moerland.
Er is misschien een zwakke schakel binnen Ares.	Er is misschien een zwakke schakel binnen Ares.
Het betreft een van de novieten. Bel me maar even terug.	Het betreft een van de novieten. Bel me maar even terug.
Je weet hoe je moet preparen?	Je weet hoe je moet preparen?
Tien liter balsemvloeistof. Als je misselijk wordt, zitten.	Tien liter balsemvloeistof. Als je misselijk wordt, zitten.
Ga daar maar staan.	Ga daar maar staan.
En toen waren er twee.	En toen waren er twee.
De lichamen zijn gedraind. Jullie hebben je ingelezen?	De lichamen zijn gedraind. Jullie hebben je ingelezen?
Absoluut. -Goed.	Absoluut. -Goed.
Succes.	Succes.
Geef me de scalpel.	Geef me de scalpel.
Wat doe je hier? -Ik loop hier stage.	Wat doe je hier? -Ik loop hier stage.
Heeft je broer dit geregeld? -Mijn vader.	Heeft je broer dit geregeld? -Mijn vader.
Die scalpel.	Die scalpel.
Fleur, het spijt me...	Fleur, het spijt me...
Geef me die fucking scalpel.	Geef me die fucking scalpel.
Dames...	Dames...
...problemen? -Nee, hoor.	...problemen? -Nee, hoor.
Een incisie aan de binnenkant van de femur. Tien liter balsemvloeistof.	Een incisie aan de binnenkant van de femur. Tien liter balsemvloeistof.
Shit. -Wil je even zitten?	Shit. -Wil je even zitten?
Nee. Het gaat prima.	Nee. Het gaat prima.
Jullie zijn een duo. Let een beetje op elkaar.	Jullie zijn een duo. Let een beetje op elkaar.
Rosa. [pauze] Let een beetje op me.	Rosa. [pauze] Let een beetje op me.
Fuck.	Fuck.
Hier. -Nee.	Hier. -Nee.
Ga je gang.	Ga je gang.
Jij bent hier de grote belofte.	Jij bent hier de grote belofte.
Shit.	Shit.
Dit is niet gedraind.	Dit is niet gedraind.
Pak die canule.	Pak die canule.
Fleur, pak die fucking canula, alsjeblieft.	Fleur, pak die fucking canula, alsjeblieft.
Shit, shit, shit.	Shit, shit, shit.

[vrouw] Rosa? Ben je klaar?	[vrouw] Rosa? Ben je klaar?
Rosa?	Rosa?
Geen drank...	Geen drank...
...geen drugs in d'r bloed.	...geen drugs in d'r bloed.
Behalve haar eigen medicatie.	Behalve haar eigen medicatie.
En ze heeft 'n belletje gepleegd vlak voordat ze dit deed.	En ze heeft 'n belletje gepleegd vlak voordat ze dit deed.
Naar wie?	Naar wie?
Naar jou.	Naar jou.
Laat ze maar weer binnen.	Laat ze maar weer binnen.
Eet wat.	Eet wat.
Hé. Heb je 'n beetje kunnen slapen?	Hé. Heb je 'n beetje kunnen slapen?
Gaat het?	Gaat het?
Mag ik even met Rosa praten?	Mag ik even met Rosa praten?
Hoe gaat 't met je, Rosa?	Hoe gaat 't met je, Rosa?
Ga zitten.	Ga zitten.
Iets te eten?	Iets te eten?
Kopje koffie?	Kopje koffie?
Wil je erover praten?	Wil je erover praten?
Vertellen wat er volgens jou gebeurde?	Vertellen wat er volgens jou gebeurde?
Hoezo wat er volgens mij gebeurde?	Hoezo wat er volgens mij gebeurde?
Ik vind het belangrijk om te weten hoe jij dit heb ervaren.	Ik vind het belangrijk om te weten hoe jij dit heb ervaren.
We proberen de situatie te overzien. We zijn er voor elkaar, Rosa.	We proberen de situatie te overzien. We zijn er voor elkaar, Rosa.
We zijn nu nog aan het gissen.	We zijn nu nog aan het gissen.
Hester slikte medicijnen die...	Hester slikte medicijnen die...
...verkeerd kunnen vallen in een bepaalde combinatie.	...verkeerd kunnen vallen in een bepaalde combinatie.
Een psychose, een ongeluk.	Een psychose, een ongeluk.
Alweer.	Alweer.
Maak jij je zorgen over je carrière?	Maak jij je zorgen over je carrière?
Mijn carrière?	Mijn carrière?
Alles blijft hier binnen deze muren, Rosa.	Alles blijft hier binnen deze muren, Rosa.
Fleur.	Fleur.
Fleur.	Fleur.
Wat doe je?	Wat doe je?
Ik heb college.	Ik heb college.
Wat heb jij gezegd dat er gebeurd is?	Wat heb jij gezegd dat er gebeurd is?
Wat er gebeurd is?	Wat er gebeurd is?
Ze is dood. Je was erbij, toch?	Ze is dood. Je was erbij, toch?
Jezus.	Jezus.
Fleur.	Fleur.
Je was er toch zelf ook bij? Je zag toch hoe ze...	Je was er toch zelf ook bij? Je zag toch hoe ze...
Ik weet niet wat ik heb gezien, Rosa.	Ik weet niet wat ik heb gezien, Rosa.
Nee...	Nee...
Fleur.	Fleur.
Niet kijken, niet kijken, niet kijken.	Niet kijken, niet kijken, niet kijken.
Haal haar weg.	Haal haar weg.
Fleur. Niet kijken.	Fleur. Niet kijken.
Nee, nee.	Nee, nee.
Jongens, ik wil jullie hier weg hebben. Allemaal weg.	Jongens, ik wil jullie hier weg hebben. Allemaal weg.
Iedereen hier weg, nu.	Iedereen hier weg, nu.
Nee...	Nee...
Kom.	Kom.
Nee.	Nee.
Dit is toch geen toeval meer?	Dit is toch geen toeval meer?
Arme Fleur.	Arme Fleur.
We hadden d'r tegen moeten houden, maar ik zag dit niet aankomen.	We hadden d'r tegen moeten houden, maar ik zag dit niet aankomen.
[Puk] Ik vind hem geen type om zoiets te doen.	[Puk] Ik vind hem geen type om zoiets te doen.
Ik heb nooit iets aan hem gemerkt.	Ik heb nooit iets aan hem gemerkt.
Jij wel?	Jij wel?
Sorry?	Sorry?
[stottert] Ik wil even liggen.	[stottert] Ik wil even liggen.
[Puk] Oké. Wil je dat ik blijf?	[Puk] Oké. Wil je dat ik blijf?
[Rosa] Nee, thanks. Ik wil even alleen zijn.	[Rosa] Nee, thanks. Ik wil even alleen zijn.
Eh, als je wil, ik ben er gewoon, hè?	Eh, als je wil, ik ben er gewoon, hè?
Ja, fijn.	Ja, fijn.
Hé, pap. Met mij.	Hé, pap. Met mij.
Eh, je neemt steeds niet op. Ik begrijp het dat je boos bent.	Eh, je neemt steeds niet op. Ik begrijp het dat je boos bent.
Maar bel me even terug, alsjeblieft.	Maar bel me even terug, alsjeblieft.
Hé, pap. Met mij nog een keer.	Hé, pap. Met mij nog een keer.
Bel me terug, alsjeblieft.	Bel me terug, alsjeblieft.
Rosa. -Hé, man.	Rosa. -Hé, man.
[Martin] Je bent thuis.	[Martin] Je bent thuis.
Ja.	Ja.
Hoef je niks?	Hoef je niks?
Ik heb al gegeten.	Ik heb al gegeten.
Ben je ziek?	Ben je ziek?
Nee.	Nee.
Je ziet er ziek uit.	Je ziet er ziek uit.
Ik ben alleen 'n beetje misselijk.	Ik ben alleen 'n beetje misselijk.
Gaat wel weer over.	Gaat wel weer over.
Hoe is het met 'r?	Hoe is het met 'r?
Interesseert dat je?	Interesseert dat je?
Ik wil d'r zien.	Ik wil d'r zien.
Dat gaat niet gebeuren.	Dat gaat niet gebeuren.
Want?	Want?
Want je moeder is eindelijk stabiel.	Want je moeder is eindelijk stabiel.
Ze heeft rust nodig.	Ze heeft rust nodig.
Je kunt niet zomaar binnen komen vallen wanneer het jou uitkomt.	Je kunt niet zomaar binnen komen vallen wanneer het jou uitkomt.
Jij kan mij niet verbieden wanneer ik haar mag zien.	Jij kan mij niet verbieden wanneer ik haar mag zien.
Zolang jij je nieuwe vrienden belangrijker vindt dan thuis...	Zolang jij je nieuwe vrienden belangrijker vindt dan thuis...
...heb je niets bij je moeder te zoeken.	...heb je niets bij je moeder te zoeken.
Hé.	Hé.
Hé.	Hé.
Was het zelfmoord?	Was het zelfmoord?
[Carmen] Je hebt 't gezien.	[Carmen] Je hebt 't gezien.
Hij heeft zich verhangen.	Hij heeft zich verhangen.
Waarna jij ineens weg was.	Waarna jij ineens weg was.
We maakten ons zorgen.	We maakten ons zorgen.
[Rosa] Sorry.	[Rosa] Sorry.
Ik had even...	Ik had even...
Ik had even nodig na het, eh...	Ik had even nodig na het, eh...
Na het ongeluk.	Na het ongeluk.
[Rosa] Ja, dat.	[Rosa] Ja, dat.
Je lijkt op je moeder.	Je lijkt op je moeder.
Zou je d'r willen zien?	Zou je d'r willen zien?
Ik kan met je meegaan.	Ik kan met je meegaan.
Waarom?	Waarom?
Ik wil je beter leren kennen.	Ik wil je beter leren kennen.
[dokter] Mevrouw...	[dokter] Mevrouw...
Sinds gistermiddag is ze een stuk coherenter en rustiger.	Sinds gistermiddag is ze een stuk coherenter en rustiger.
Als de situatie stabiel blijft, dan passen we de medicatie er ook op aan.	Als de situatie stabiel blijft, dan passen we de medicatie er ook op aan.
Mocht ze nog wat onverschillig zijn, dat kan ook een kenmerk...	Mocht ze nog wat onverschillig zijn, dat kan ook een kenmerk...
...zijn van de medicatie die we hebben toegediend.	...zijn van de medicatie die we hebben toegediend.
Hé.	Hé.
Vijf minuten, niet langer. Daarna moeten ze weg.	Vijf minuten, niet langer. Daarna moeten ze weg.
Ga je gang.	Ga je gang.
Hé, mama.	Hé, mama.
Mam?	Mam?
Engeltje.	Engeltje.
Ach, lieverd, alles komt toch goed?	Ach, lieverd, alles komt toch goed?
Dat weet ik niet.	Dat weet ik niet.
Tuurlijk wel.	Tuurlijk wel.
Papa is hier elke dag.	Papa is hier elke dag.
Hè, d'r wordt goed voor me gezorgd.	Hè, d'r wordt goed voor me gezorgd.
Hè, da's fijn. [huilsnuif]	Hè, da's fijn. [huilsnuif]
En met jou? Gaat het goed met jou?	En met jou? Gaat het goed met jou?
Ja.	Ja.
Ik droom over je.	Ik droom over je.
De hele tijd.	De hele tijd.
[Rosa] Echt waar?	[Rosa] Echt waar?
Wat droom je dan?	Wat droom je dan?
[Joyce] Wat droom ik?	[Joyce] Wat droom ik?
Hai.	Hai.
Hallo.	Hallo.
Dit is... [stilte] Dit is een vriendin. Carmen.	Dit is... [stilte] Dit is een vriendin. Carmen.
Carmen.	Carmen.
Zwanenburg.	Zwanenburg.
Zwanenburg?	Zwanenburg?
Zegt die naam je iets?	Zegt die naam je iets?
Wat doen jullie hier?	Wat doen jullie hier?
[Rosa] Mam?	[Rosa] Mam?
Wat is er?	Wat is er?
Weg.	Weg.
Je moet hier weg.	Je moet hier weg.
Je moet weg.	Je moet weg.
Wat? -Maurits zit hierachter.	Wat? -Maurits zit hierachter.
Wat doe je?	Wat doe je?
Vertel ons eens meer over Maurits, Joyce.	Vertel ons eens meer over Maurits, Joyce.
Maurits.	Maurits.
Hoe kent mijn moeder jouw vader? Wat is dit?	Hoe kent mijn moeder jouw vader? Wat is dit?
Ze hadden grote plannen samen.	Ze hadden grote plannen samen.
Nee.	Nee.
Mam? Mam.	Mam? Mam.
Nee, nee.	Nee, nee.
[Joyce] Ik zeg 't niet. -Mama.	[Joyce] Ik zeg 't niet. -Mama.
Mam.	Mam.
Wat hebben ze met je gedaan?	Wat hebben ze met je gedaan?
Ga niet terug.	Ga niet terug.
Ze houden daar iets gevangen.	Ze houden daar iets gevangen.
Mama... -Onder Ares.	Mama... -Onder Ares.
Het maakt je gek.	Het maakt je gek.
Het neemt alles af.	Het neemt alles af.
Het neemt alles. Het eet je op. -Hou op. Hou op.	Het neemt alles. Het eet je op. -Hou op. Hou op.
Wat? Wat dan?	Wat? Wat dan?
Beal.	Beal.
Nee, laat me los. Rosa.	Nee, laat me los. Rosa.
Laat me los.	Laat me los.
Laat me alleen.	Laat me alleen.
Nee.	Nee.
Nee.	Nee.
Rosa.	Rosa.
Kalmeer haar.	Kalmeer haar.
Nee.	Nee.
Nee.	Nee.
Nee...	Nee...
Sst.	Sst.
Waarom deed je dat?	Waarom deed je dat?
Wat was dat?	Wat was dat?
Ik moest het zeker weten.	Ik moest het zeker weten.
Wat?	Wat?
Ze waren verloofd, Rosa.	Ze waren verloofd, Rosa.
Ze zat bij Ares.	Ze zat bij Ares.
Mijn vader had me de opdracht gegeven jou erbij te halen.	Mijn vader had me de opdracht gegeven jou erbij te halen.
Aanvankelijk had ik geen idee waarom.	Aanvankelijk had ik geen idee waarom.
Ze waren verloofd?	Ze waren verloofd?
Hoelang weet jij dit al?	Hoelang weet jij dit al?
Wat zit er onder Ares?	Wat zit er onder Ares?
Wat bedoelt ze met jullie houden iets gevangen onder Ares?	Wat bedoelt ze met jullie houden iets gevangen onder Ares?
Rosa...	Rosa...
Zeg het me.	Zeg het me.
Zeg het me. -Ik weet het niet.	Zeg het me. -Ik weet het niet.
Oké.	Oké.
Je had gelijk.	Je had gelijk.
Ik weet niks.	Ik weet niks.
Ze vertellen mij niks.	Ze vertellen mij niks.
Niks meer dan een hoop bullshit.	Niks meer dan een hoop bullshit.
Regeltjes.	Regeltjes.
Beal is 'n verzinsel, Rosa.	Beal is 'n verzinsel, Rosa.
Een sprookje.	Een sprookje.
Toch?	Toch?
Jacob.	Jacob.
Rijden.	Rijden.
Ja?	Ja?
Bij haar moeder? Hoelang zijn ze daar gebleven?	Bij haar moeder? Hoelang zijn ze daar gebleven?
Bel me als ze weer bij Ares zijn.	Bel me als ze weer bij Ares zijn.
Ben je wakker?	Ben je wakker?
[Oud-Nederlands] Gij zijt bang.	[Oud-Nederlands] Gij zijt bang.
Ik kan 't ruiken.	Ik kan 't ruiken.
[moeizaam inhaleren] Er is weer een gekozene gestorven.	[moeizaam inhaleren] Er is weer een gekozene gestorven.
Een jongen.	Een jongen.
Tweeëntwintig.	Tweeëntwintig.
Onschuldig.	Onschuldig.
[Oud-Nederlands] Onschuldig siet gie lange niet meer.	[Oud-Nederlands] Onschuldig siet gie lange niet meer.
[Oud-Nederlands] Gie zijt zo gevoelig, mijne jongen.	[Oud-Nederlands] Gie zijt zo gevoelig, mijne jongen.
[Oud-Nederlands] Het kwaad blijft boos.	[Oud-Nederlands] Het kwaad blijft boos.
[Oud-Nederlands] Er moge vrouwelijk bloede op de troon.	[Oud-Nederlands] Er moge vrouwelijk bloede op de troon.
[Oud-Nederlands] Nieuw bloede.	[Oud-Nederlands] Nieuw bloede.
[Oud-Nederlands] Ze is er nog niet klaar voor.	[Oud-Nederlands] Ze is er nog niet klaar voor.
[Oud-Nederlands] Dat bepale gie niet.	[Oud-Nederlands] Dat bepale gie niet.
Maurits.	Maurits.
[Oud-Nederlands] Gie moet doen wat ik ha dien...	[Oud-Nederlands] Gie moet doen wat ik ha dien...
...om te overleven.	...om te overleven.
En dat is?	En dat is?
[modern Nederlands] Met je tijd meegaan.	[modern Nederlands] Met je tijd meegaan.
[Carmen] Denk na, Steenwijk. Wat wil je doen?	[Carmen] Denk na, Steenwijk. Wat wil je doen?
[Rosa] We moeten voorzichtig zijn.	[Rosa] We moeten voorzichtig zijn.
Steenwijk, laat 't aan mij over.	Steenwijk, laat 't aan mij over.
Rosa.	Rosa.
Hé, ben je d'r weer?	Hé, ben je d'r weer?
Ja.	Ja.
Heb jij Jacob gezien?	Heb jij Jacob gezien?
Nee.	Nee.
Al uren niet. Ik dacht dat hij misschien bij jou was.	Al uren niet. Ik dacht dat hij misschien bij jou was.
Ik ga even naar mijn kamer. -Ja.	Ik ga even naar mijn kamer. -Ja.
Ze is met mij.	Ze is met mij.
Is dat zo?	Is dat zo?
Ja.	Ja.
Waar is dit allemaal voor?	Waar is dit allemaal voor?
Orders van hogere hand.	Orders van hogere hand.
De alumni komen dineren vanavond.	De alumni komen dineren vanavond.
Welke?	Welke?
Iedereen.	Iedereen.
Ze gaan een nieuwe kandidaat uitkiezen.	Ze gaan een nieuwe kandidaat uitkiezen.
Ik hoop niet dat ik morgen aan een balk hang.	Ik hoop niet dat ik morgen aan een balk hang.
[Marije] Alsof jij president wordt, lamlul.	[Marije] Alsof jij president wordt, lamlul.
[Marije] Ze is terug.	[Marije] Ze is terug.
En ze doet alsof er niks aan de hand is.	En ze doet alsof er niks aan de hand is.
Je laat het niet zo maar gebeuren.	Je laat het niet zo maar gebeuren.
Ach, arm mens.	Ach, arm mens.
Gaat het wel?	Gaat het wel?
[Jacob] Ik ben er bijna.	[Jacob] Ik ben er bijna.
Ik voel het.	Ik voel het.
Ze hebben geprobeerd het van ons weg te houden.	Ze hebben geprobeerd het van ons weg te houden.
Maar het riep mij.	Maar het riep mij.
Het vroeg mij om hulp.	Het vroeg mij om hulp.
Vanavond ga ik het bevrijden.	Vanavond ga ik het bevrijden.
[Rosa] Je bedoelt Beal?	[Rosa] Je bedoelt Beal?
Vanavond gaan we je bevrijden, Beal.	Vanavond gaan we je bevrijden, Beal.
Jacob...	Jacob...
...we gaan naar huis.	...we gaan naar huis.
Hebben ze jou hier gestuurd om mij te halen?	Hebben ze jou hier gestuurd om mij te halen?
Hè? -Nee.	Hè? -Nee.
Hè?	Hè?
Niemand heeft mij gestuurd. Kom, we gaan hier samen weg, oké?	Niemand heeft mij gestuurd. Kom, we gaan hier samen weg, oké?
Jacob.	Jacob.
[kreunt] Jacob.	[kreunt] Jacob.
[Rosa] Wat doe je?	[Rosa] Wat doe je?
Wat is er?	Wat is er?
[Lodewijk] Dank je wel, Leopold.	[Lodewijk] Dank je wel, Leopold.
Dan zien we je vanavond.	Dan zien we je vanavond.
Ja.	Ja.
Dag.	Dag.
Dat was de laatste.	Dat was de laatste.
Iedereen komt.	Iedereen komt.
Ze willen allemaal weten wie het wordt. Daar ben ik ook wel benieuwd naar.	Ze willen allemaal weten wie het wordt. Daar ben ik ook wel benieuwd naar.
[Maurits] Het is cruciaal dat de volgende president de juiste wordt.	[Maurits] Het is cruciaal dat de volgende president de juiste wordt.
Borms heeft 't alleen maar...	Borms heeft 't alleen maar...
...bozer gemaakt.	...bozer gemaakt.
Volgens gebruik is Roderick van Hal de volgende kandidaat.	Volgens gebruik is Roderick van Hal de volgende kandidaat.
Toen in '53 de dijk brak.	Toen in '53 de dijk brak.
Achttienhonderd zesendertig doden...	Achttienhonderd zesendertig doden...
...tienduizenden dieren, honderdduizend huizen...	...tienduizenden dieren, honderdduizend huizen...
...tweehonderdduizend hectare grond.	...tweehonderdduizend hectare grond.
Alles en iedereen onder water.	Alles en iedereen onder water.
En weet jij waarom?	En weet jij waarom?
Waarom?	Waarom?
Omdat we niet vooruitdachten.	Omdat we niet vooruitdachten.
We gingen niet mee met onze tijd.	We gingen niet mee met onze tijd.
Het wordt met de dag onrustiger.	Het wordt met de dag onrustiger.
Of denk je dat die zelfmoorden toeval zijn?	Of denk je dat die zelfmoorden toeval zijn?
Het is mijn taak om het weer te kalmeren voor het uit de hand loopt.	Het is mijn taak om het weer te kalmeren voor het uit de hand loopt.
Dat is onze taak.	Dat is onze taak.
Jij wilt de enige buitenstaander de sleutels geven.	Jij wilt de enige buitenstaander de sleutels geven.
Als je dan per se wil dat het een vrouw wordt...	Als je dan per se wil dat het een vrouw wordt...
...laat het dan iemand uit een van de families zijn.	...laat het dan iemand uit een van de families zijn.
Wie anders?	Wie anders?
Voordat je iets zegt... [zwaar ademend]	Voordat je iets zegt... [zwaar ademend]
...ik ben al meer dan een jaar senaat.	...ik ben al meer dan een jaar senaat.
Je hebt me gepasseerd bij Joost.	Je hebt me gepasseerd bij Joost.
Je hebt me gepasseerd bij Arnold Borms, maar...	Je hebt me gepasseerd bij Arnold Borms, maar...
Ik ga me niet voorbij laten streven door een noviet.	Ik ga me niet voorbij laten streven door een noviet.
Denk na, Maurits.	Denk na, Maurits.
Papa, je moet naar me luisteren.	Papa, je moet naar me luisteren.
Ik weet dat er een soort test aan voorafgaat.	Ik weet dat er een soort test aan voorafgaat.
Ik ben er klaar voor.	Ik ben er klaar voor.
Meer dan zij.	Meer dan zij.
Papa, ik praat tegen je.	Papa, ik praat tegen je.
Oké.	Oké.
Goed.	Goed.
Rij terug naar Ares.	Rij terug naar Ares.
Wij bereiden het voor.	Wij bereiden het voor.
Oké.	Oké.
Top.	Top.
Je hebt gelijk. We houden dit binnen de families.	Je hebt gelijk. We houden dit binnen de families.
Waar ga jij heen?	Waar ga jij heen?
Op de vlucht?	Op de vlucht?
Doei, Fleur.	Doei, Fleur.
Wat is dit, Steenwijk?	Wat is dit, Steenwijk?
Waar is Carmen?	Waar is Carmen?
Je zal het met mij moeten doen.	Je zal het met mij moeten doen.
Waar wilde je heen?	Waar wilde je heen?
Hmm?	Hmm?
Ik vind het echt heel erg wat er met Arnold is gebeurd.	Ik vind het echt heel erg wat er met Arnold is gebeurd.
Jij bent een moordenaar.	Jij bent een moordenaar.
Mijn broer pleegt geen zelfmoord.	Mijn broer pleegt geen zelfmoord.
Alles staat in de fik sinds jij hier bent.	Alles staat in de fik sinds jij hier bent.
Dus wat moeten wij nou van je vinden, Steenwijk?	Dus wat moeten wij nou van je vinden, Steenwijk?
Van Hal beweerde dat ze al geeft. Hij zag 'r in de doopkamer.	Van Hal beweerde dat ze al geeft. Hij zag 'r in de doopkamer.
Geef jij al?	Geef jij al?
Als noviet?	Als noviet?
Ik ga naar huis.	Ik ga naar huis.
Je bent thuis.	Je bent thuis.
Kijk niet zo serieus.	Kijk niet zo serieus.
[Maurits] Kom.	[Maurits] Kom.
Er is haast.	Er is haast.
Nog een...	Nog een...
...vaderlijk woord van advies... [stilte]	...vaderlijk woord van advies... [stilte]
...vooraf?	...vooraf?
We zoeken...	We zoeken...
...het meest pure dat in jou zit.	...het meest pure dat in jou zit.
Een op maat gemaakte test.	Een op maat gemaakte test.
Voor iedereen anders.	Voor iedereen anders.
Voor iedereen persoonlijk.	Voor iedereen persoonlijk.
Dood het, Carmen.	Dood het, Carmen.
Dit meen je niet, toch?	Dit meen je niet, toch?
Het is een grap, toch, pap?	Het is een grap, toch, pap?
Dit is... [stilte]	Dit is... [stilte]
...het belangrijkste moment uit jouw leven. [stilte]	...het belangrijkste moment uit jouw leven. [stilte]
We hebben dit allemaal moeten doen.	We hebben dit allemaal moeten doen.
Nee.	Nee.
De eerste vrouw van ons broederschap. Doe 't, Carmen.	De eerste vrouw van ons broederschap. Doe 't, Carmen.
Het moet. Je moet.	Het moet. Je moet.
Doe het.	Doe het.
Doe het.	Doe het.
Er zijn nog jongens in de senaat die we kunnen benaderen.	Er zijn nog jongens in de senaat die we kunnen benaderen.
Maurits, iedereen is onderweg.	Maurits, iedereen is onderweg.
Allemaal.	Allemaal.
Ja.	Ja.
Laten we ze gaan verwelkomen.	Laten we ze gaan verwelkomen.
[David] Zitten.	[David] Zitten.
[Marije] Nou, laat maar zien wat je kan.	[Marije] Nou, laat maar zien wat je kan.
Doe d'r mond open.	Doe d'r mond open.
Hou d'r fatsoenlijk vast, man.	Hou d'r fatsoenlijk vast, man.
Niets. Zie je nou wel?	Niets. Zie je nou wel?
Je weet wat je moet doen.	Je weet wat je moet doen.
[Marije] Ze heeft bekend.	[Marije] Ze heeft bekend.
Joost, Hester de Hoogh, Arnold.	Joost, Hester de Hoogh, Arnold.
Je lult.	Je lult.
Ze heeft ze alle drie vermoord.	Ze heeft ze alle drie vermoord.
Laat het zichzelf oplossen.	Laat het zichzelf oplossen.
Nee. [angstig hijgend] -Mijn broer haatte mensen zoals jij.	Nee. [angstig hijgend] -Mijn broer haatte mensen zoals jij.
[Roderick] Rosa. Roos. Roos.	[Roderick] Rosa. Roos. Roos.
Niet doen.	Niet doen.
Niet jij.	Niet jij.
Vanavond laten we je vrij, Beal.	Vanavond laten we je vrij, Beal.
Ik spreek namens Beal. Jullie zijn allemaal stervende.	Ik spreek namens Beal. Jullie zijn allemaal stervende.
[man] Rustig. Houd hem vast.	[man] Rustig. Houd hem vast.
Blijf rustig. Blijf rustig.	Blijf rustig. Blijf rustig.
Neem hem mee.	Neem hem mee.
Blijf rustig.	Blijf rustig.
Ondertiteld door: Willem Siers	Ondertiteld door: Willem Siers

[Lodewijk] Blijf bij hem. Ik moet verder met de voorbereidingen.	[Lodewijk] Blijf bij hem. Ik moet verder met de voorbereidingen.
Daarna wordt ie opgehaald.	Daarna wordt ie opgehaald.
Kan je ons even alleen laten?	Kan je ons even alleen laten?
[Jacob] Carmen...	[Jacob] Carmen...
...zeg Rosa dat ik 'r vertrouw.	...zeg Rosa dat ik 'r vertrouw.
[Lodewijk] Carmen...	[Lodewijk] Carmen...
Ze moet het vrijlaten, het goede doen. -[tegen Carmen] Weg nu. Kom maar.	Ze moet het vrijlaten, het goede doen. -[tegen Carmen] Weg nu. Kom maar.
Wat staan jullie te doen?	Wat staan jullie te doen?
Roderick, waar is Rosa?	Roderick, waar is Rosa?
Je hebt wat gemist.	Je hebt wat gemist.
[Maurits] Wist jij dat het Jacob was die al die moorden heeft gepleegd?	[Maurits] Wist jij dat het Jacob was die al die moorden heeft gepleegd?
En wist jij dat ie in de catacomben is geweest?	En wist jij dat ie in de catacomben is geweest?
Ja.	Ja.
Heeft ie je verteld wat hij daar heeft gezien?	Heeft ie je verteld wat hij daar heeft gezien?
Nee.	Nee.
Ik zal d'r voor zorgen dat het weer wordt afgesloten.	Ik zal d'r voor zorgen dat het weer wordt afgesloten.
Is veiliger voor iedereen.	Is veiliger voor iedereen.
Dit was ook haar kamer.	Dit was ook haar kamer.
In haar hoogtijdagen was jouw moeder een fenomenale vrouw.	In haar hoogtijdagen was jouw moeder een fenomenale vrouw.
Jullie waren verloofd.	Jullie waren verloofd.
Ja.	Ja.
Dat waren we ja.	Dat waren we ja.
En toen hebben jullie haar kapotgemaakt.	En toen hebben jullie haar kapotgemaakt.
Nee.	Nee.
Ze had hier nooit weg moeten gaan, Rosa.	Ze had hier nooit weg moeten gaan, Rosa.
Kom, sta 's op.	Kom, sta 's op.
God, wat lijk je toch op haar.	God, wat lijk je toch op haar.
Dezelfde strijdlust, [inhalering] zelfde ogen.	Dezelfde strijdlust, [inhalering] zelfde ogen.
Ik heb de ogen van m'n vader.	Ik heb de ogen van m'n vader.
Je vader?	Je vader?
Waarom ze toen voor hem koos, daar hebben we toen niks van begrepen.	Waarom ze toen voor hem koos, daar hebben we toen niks van begrepen.
Toen hij als buitenstaander haar meenam uit Ares, heeft hij haar klein gemaakt.	Toen hij als buitenstaander haar meenam uit Ares, heeft hij haar klein gemaakt.
Door haar ambities niet serieus te nemen.	Door haar ambities niet serieus te nemen.
Zoals ie jouw ambities niet serieus neemt.	Zoals ie jouw ambities niet serieus neemt.
Hij gelooft niet in jou, Rosa.	Hij gelooft niet in jou, Rosa.
Hij is er niet voor je.	Hij is er niet voor je.
Nooit geweest ook.	Nooit geweest ook.
Je maakt één zelfstandige keuze...	Je maakt één zelfstandige keuze...
...je kiest voor jezelf, voor je ontwikkeling...	...je kiest voor jezelf, voor je ontwikkeling...
...en waar is ie nu?	...en waar is ie nu?
Ons genootschap vergt een bepaalde mate van zelfopoffering.	Ons genootschap vergt een bepaalde mate van zelfopoffering.
En het vermogen tot zelfopoffering...	En het vermogen tot zelfopoffering...
...maakt het verschil tussen leiders en volgers.	...maakt het verschil tussen leiders en volgers.
En dit genootschap leiden, vraagt absoluut alles.	En dit genootschap leiden, vraagt absoluut alles.
Ik zie iets in jou, Rosa.	Ik zie iets in jou, Rosa.
Vanaf het moment dat jij hier binnenkwam, voelde ik 't.	Vanaf het moment dat jij hier binnenkwam, voelde ik 't.
Ik durfde er niet aan toe te geven, maar...	Ik durfde er niet aan toe te geven, maar...
Rosa, als jij vanavond...	Rosa, als jij vanavond...
...bereid bent de juiste keuzes te maken...	...bereid bent de juiste keuzes te maken...
...dan word jij onze nieuwe president.	...dan word jij onze nieuwe president.
En dan mogen we ons zó gelukkig prijzen.	En dan mogen we ons zó gelukkig prijzen.
Jij hebt het in je, Rosa, om een nieuw soort leider te worden.	Jij hebt het in je, Rosa, om een nieuw soort leider te worden.
Een níeuw soort leider...	Een níeuw soort leider...
...in deze interessante tijd.	...in deze interessante tijd.
Waarom vertel je d'r niet gewoon wat je met 'r van plan bent?	Waarom vertel je d'r niet gewoon wat je met 'r van plan bent?
Wat ze ervoor moet doen? -Carmen, ik ben even in gesprek met Rosa.	Wat ze ervoor moet doen? -Carmen, ik ben even in gesprek met Rosa.
Wat houden jullie gevangen onder Ares? -Carmen.	Wat houden jullie gevangen onder Ares? -Carmen.
Ik stel een vraag. Wat houden jullie gevangen onder dit gebouw?	Ik stel een vraag. Wat houden jullie gevangen onder dit gebouw?
Carmen, die informatie kan alleen gedeeld worden met oud-presidenten.	Carmen, die informatie kan alleen gedeeld worden met oud-presidenten.
[blik op Rosa] En de huidige leider.	[blik op Rosa] En de huidige leider.
Kom eens even binnen.	Kom eens even binnen.
Alles meenemen.	Alles meenemen.
Kom je, Rosa?	Kom je, Rosa?
[ademt uit] Je weet niet wat ie van je vraagt.	[ademt uit] Je weet niet wat ie van je vraagt.
Alsjeblieft, doe het niet.	Alsjeblieft, doe het niet.
[Maurits] Rosa...	[Maurits] Rosa...
Jacob wilde dat ik iets doorgeef aan je.	Jacob wilde dat ik iets doorgeef aan je.
Ik moest doorgeven dat ie je vertrouwt.	Ik moest doorgeven dat ie je vertrouwt.
Om het goede te doen.	Om het goede te doen.
Carmen, laat haar.	Carmen, laat haar.
Kom, Rosa. Kom.	Kom, Rosa. Kom.
Kom maar.	Kom maar.
Waarde leden, voordat wij deze avond officieel gaan openen...	Waarde leden, voordat wij deze avond officieel gaan openen...
...wil ik eerst onze junioren bedanken voor de prachtige aankleding. Bedankt.	...wil ik eerst onze junioren bedanken voor de prachtige aankleding. Bedankt.
Op deze uitzonderlijke avond is Ares voor alumni. Dank jullie wel.	Op deze uitzonderlijke avond is Ares voor alumni. Dank jullie wel.
Moeten wij nou weg?	Moeten wij nou weg?
[fluisterend] Dat is helemaal niet volgens 't protocol.	[fluisterend] Dat is helemaal niet volgens 't protocol.
Ga jij Zwanenburg tegenspreken?	Ga jij Zwanenburg tegenspreken?
[Maurits] De tafelschikking, echter, is van mijn hand.	[Maurits] De tafelschikking, echter, is van mijn hand.
[man 1] Doorlopen.	[man 1] Doorlopen.
[man 2] Doorlopen, naar buiten.	[man 2] Doorlopen, naar buiten.
[man 1] Oké, doorlopen.	[man 1] Oké, doorlopen.
Dames en heren.	Dames en heren.
Dames en heren.	Dames en heren.
Leden van Ares, welkom.	Leden van Ares, welkom.
Mag ik eerst de kring vragen te gaan staan.	Mag ik eerst de kring vragen te gaan staan.
Waarde leden...	Waarde leden...
...al enige tijd ben ik verantwoordelijk...	...al enige tijd ben ik verantwoordelijk...
...voor de [stilte] doorstroom binnen ons Ares.	...voor de [stilte] doorstroom binnen ons Ares.
Verantwoordelijk voor puurheid...	Verantwoordelijk voor puurheid...
...voor zuiverheid en een consistentie daarin.	...voor zuiverheid en een consistentie daarin.
Oké, draai je om. Dan maak ik je los.	Oké, draai je om. Dan maak ik je los.
Nee.	Nee.
Maar Beal is onrustig.	Maar Beal is onrustig.
Al jaren zoals u allen weet, is Ares... [stilte]	Al jaren zoals u allen weet, is Ares... [stilte]
...uit balans.	...uit balans.
En zelfs de jonge onschuld slaagt er niet in...	En zelfs de jonge onschuld slaagt er niet in...
...het evenwicht te herstellen.	...het evenwicht te herstellen.
Wat nee?	Wat nee?
Jacob, dit [inhalering] is geen test.	Jacob, dit [inhalering] is geen test.
Het is echt.	Het is echt.
Je loopt zo achter mij aan. Rechtstreeks naar buiten. Geen vragen.	Je loopt zo achter mij aan. Rechtstreeks naar buiten. Geen vragen.
Nee, nee, nee.	Nee, nee, nee.
Het is tijd voor 'n omslag.	Het is tijd voor 'n omslag.
Het is tijd voor 'n radicale verandering.	Het is tijd voor 'n radicale verandering.
Jacob...	Jacob...
...ze gaan haar president maken.	...ze gaan haar president maken.
En ik weet wat ze daarvoor moet doen.	En ik weet wat ze daarvoor moet doen.
Dames en heren...	Dames en heren...
...mag ik u voorstellen aan de nieuwe kandidaat?	...mag ik u voorstellen aan de nieuwe kandidaat?
Rosa Steenwijk.	Rosa Steenwijk.
Rosa...	Rosa...
Rosa. Doe het niet.	Rosa. Doe het niet.
Rosa.	Rosa.
Maak je keuze, Rosa.	Maak je keuze, Rosa.
Hé.	Hé.
Hé.	Hé.
Ik zei toch dat zo'n studentenvereniging niks voor jou is?	Ik zei toch dat zo'n studentenvereniging niks voor jou is?
Ze maken me president.	Ze maken me president.
Ja.	Ja.
Ik zie het.	Ik zie het.
Ik voel mezelf niet meer.	Ik voel mezelf niet meer.
Rosa, kijk me aan.	Rosa, kijk me aan.
Jij bent Rosa Steenwijk, toch?	Jij bent Rosa Steenwijk, toch?
Ja.	Ja.
Doe dan wat ze van je vragen.	Doe dan wat ze van je vragen.
Maak het af, word leider.	Maak het af, word leider.
Dan kun jij Beal bevrijden.	Dan kun jij Beal bevrijden.
[fluisterend] Nee.	[fluisterend] Nee.
Jawel.	Jawel.
Jawel. -Nee.	Jawel. -Nee.
Jij hebt nog nooit in je leven iets opgegeven.	Jij hebt nog nooit in je leven iets opgegeven.
Roos...	Roos...
Eerst was ik alleen...	Eerst was ik alleen...
...en toen was jij d'r uit het niets.	...en toen was jij d'r uit het niets.
Dat was geen toeval.	Dat was geen toeval.
Ik dacht dat ík degene was die het af moet maken...	Ik dacht dat ík degene was die het af moet maken...
...maar ik ben onderdeel van het probleem.	...maar ik ben onderdeel van het probleem.
Ik, mijn familie.	Ik, mijn familie.
Ik begrijp niet wat je bedoelt.	Ik begrijp niet wat je bedoelt.
Jij moet Beal bevrijden.	Jij moet Beal bevrijden.
Dat is waarom we elkaar hebben ontmoet.	Dat is waarom we elkaar hebben ontmoet.
Dat is waarom jij om mij bent gaan geven. En ik om jou.	Dat is waarom jij om mij bent gaan geven. En ik om jou.
Snap je dat?	Snap je dat?
[Maurits] Doe het, Rosa.	[Maurits] Doe het, Rosa.
[Jacob] Doe het.	[Jacob] Doe het.
Doe wat ze van je vragen.	Doe wat ze van je vragen.
Vrij...	Vrij...
Bravo, Rosa.	Bravo, Rosa.
Wat je nu voelt, is straks allemaal voorbij.	Wat je nu voelt, is straks allemaal voorbij.
We hebben dit allemaal moeten doen.	We hebben dit allemaal moeten doen.
Kom.	Kom.
Sta op.	Sta op.
Mevrouw de president.	Mevrouw de president.
Ik begrijp dat een aantal van u twijfels zullen hebben.	Ik begrijp dat een aantal van u twijfels zullen hebben.
Een vrouwelijke president met een andere achtergrond.	Een vrouwelijke president met een andere achtergrond.
Maar we moeten mee. We moeten mee met onze tijd.	Maar we moeten mee. We moeten mee met onze tijd.
Dit is wat nodig is om Beal tot rust te krijgen.	Dit is wat nodig is om Beal tot rust te krijgen.
Waarde Aresleden, [stilte] de toekomst.	Waarde Aresleden, [stilte] de toekomst.
Nog even, Rosa, en dan mag je.	Nog even, Rosa, en dan mag je.
Op Ares.	Op Ares.
[allen] Op Ares.	[allen] Op Ares.
Ik wil het zien.	Ik wil het zien.
Ik wil Beal zien.	Ik wil Beal zien.
Ze is president.	Ze is president.
[man] Carmen...	[man] Carmen...
Waar is Beal?	Waar is Beal?
[Maurits] Beal...	[Maurits] Beal...
...een verhaal dat we de rest van de leden vertellen.	...een verhaal dat we de rest van de leden vertellen.
Om te vrezen.	Om te vrezen.
Ik ben Beal.	Ik ben Beal.
Jij bent Beal.	Jij bent Beal.
Wij zijn Beal.	Wij zijn Beal.
Prachtig, hè?	Prachtig, hè?
Ouder dan Amsterdam.	Ouder dan Amsterdam.
Niemand weet hoe oud precies...	Niemand weet hoe oud precies...
...maar wij zijn de eersten die dit ten volle benutten.	...maar wij zijn de eersten die dit ten volle benutten.
Er is geen monster.	Er is geen monster.
Meisje...	Meisje...
Nee. Dit is alles wat wij afstoten. Waar we over zwijgen.	Nee. Dit is alles wat wij afstoten. Waar we over zwijgen.
De doofpot.	De doofpot.
Zodat wíj de beslissingen kunnen nemen waartoe anderen niet in staat zijn.	Zodat wíj de beslissingen kunnen nemen waartoe anderen niet in staat zijn.
Zodat wíj de leiders kunnen zijn die dit land nodig heeft.	Zodat wíj de leiders kunnen zijn die dit land nodig heeft.
Het vasthouden van welvaart vergt leiderschap.	Het vasthouden van welvaart vergt leiderschap.
En leiderschap vergt offers.	En leiderschap vergt offers.
Al vijfhonderd jaar lang.	Al vijfhonderd jaar lang.
Gouden Eeuw, onze huidige welvaart...	Gouden Eeuw, onze huidige welvaart...
...alles waarin dit kleine land groot kan zijn.	...alles waarin dit kleine land groot kan zijn.
Nee.	Nee.
[angstkreten en kreten] Weg. Weg hier. Maak dat je wegkomt. Kom.	[angstkreten en kreten] Weg. Weg hier. Maak dat je wegkomt. Kom.
[Lodewijk] Maurits?	[Lodewijk] Maurits?
Maurits.	Maurits.


